DATE,TOTAL_CASES,NEW_CASES,TOTAL_CONFIRMED,NEW_CONFIRMED,TOTAL_PROBABLE,NEW_PROBABLE,POS_TESTS,NEG_TESTS,TOTAL_TESTS,NEW_TESTS,NEW_DEATHS,TOTAL_DEATHS,NEW_ACTIVE,TOTAL_ACTIVE,NEW_INACTIVE_RECOVERED,TOTAL_INACTIVE_RECOVERED,NEW_HOSP,TOTAL_HOSP,TOTAL_DEATHS_BY_DOD,NEW_DEATHS_BY_DOD
05-16-21,858355,284,707663,205,150692,79,815240,7026907,7842147,5303,4,12327,-249,7667,529,838361,0,21621,12318,0
05-15-21,858071,421,707458,297,150613,124,814982,7021862,7836844,8620,1,12323,-184,7916,604,837832,2,21621,12318,2
05-14-21,857650,836,707161,585,150489,251,814591,7013633,7828224,12102,10,12322,96,8100,730,837228,10,21619,12316,3
05-13-21,856814,728,706576,480,150238,248,813909,7002213,7816122,12403,7,12312,-159,8004,880,836498,9,21609,12313,3
05-12-21,856086,904,706096,661,149990,243,813348,6990371,7803719,17235,9,12305,-49,8163,944,835618,21,21600,12310,7
05-11-21,855182,853,705435,616,149747,237,812526,6973958,7786484,11479,4,12296,-137,8212,986,834674,25,21579,12303,5
05-10-21,854329,629,704819,373,149510,256,811880,6963125,7775005,7515,16,12292,-575,8349,1188,833688,28,21554,12298,9
05-09-21,853700,376,704446,282,149254,94,811447,6956043,7767490,6855,19,12276,-337,8924,694,832500,18,21526,12289,7
05-08-21,853324,561,704164,395,149160,166,811121,6949514,7760635,10283,0,12257,-77,9261,638,831806,10,21508,12282,7
05-07-21,852763,1036,703769,731,148994,305,810613,6939739,7750352,15003,2,12257,74,9338,960,831168,21,21498,12275,7
05-06-21,851727,791,703038,541,148689,250,809756,6925593,7735349,11578,11,12255,-292,9264,1072,830208,22,21477,12268,8
05-05-21,850936,1209,702497,758,148439,451,809119,6914652,7723771,17618,16,12244,218,9556,975,829136,30,21455,12260,10
05-04-21,849727,854,701739,597,147988,257,808241,6897912,7706153,12167,11,12228,-316,9338,1159,828161,27,21425,12250,9
05-03-21,848873,656,701142,449,147731,207,807547,6886439,7693986,8387,13,12217,-652,9654,1295,827002,27,21398,12241,5
05-02-21,848217,499,700693,373,147524,126,807023,6878576,7685599,7365,1,12204,-230,10306,728,825707,19,21371,12236,10
05-01-21,847718,607,700320,444,147398,163,806582,6871652,7678234,10367,-1,12203,-137,10536,745,824979,21,21352,12226,7
04-30-21,847111,1074,699876,769,147235,305,806079,6861788,7667867,14984,7,12204,2,10673,1065,824234,26,21331,12219,10
04-29-21,846037,1060,699107,695,146930,365,805206,6847677,7652883,14650,9,12197,-102,10671,1153,823169,26,21305,12209,9
04-28-21,844977,1202,698412,864,146565,338,804424,6833809,7638233,20540,17,12188,-88,10773,1273,822016,42,21279,12200,9
04-27-21,843775,1163,697548,711,146227,452,803425,6814268,7617693,13782,8,12171,-79,10861,1234,820743,41,21237,12191,12
04-26-21,842612,1096,696837,714,145775,382,802624,6801287,7603911,9834,11,12163,-369,10940,1454,819509,26,21196,12179,10
04-25-21,841516,553,696123,426,145393,127,801833,6792244,7594077,8248,6,12152,-273,11309,820,818055,25,21170,12169,7
04-24-21,840963,754,695697,566,145266,188,801318,6784511,7585829,13047,0,12146,-176,11582,930,817235,29,21145,12162,7
04-23-21,840209,955,695131,691,145078,264,800670,6772112,7572782,14911,4,12146,-219,11758,1170,816305,22,21116,12155,5
04-22-21,839254,1895,694440,1075,144814,820,799824,6758047,7557871,22085,12,12142,598,11977,1285,815135,30,21094,12150,12
04-21-21,837359,1407,693365,950,143994,457,798632,6737154,7535786,17944,19,12130,141,11379,1247,813850,20,21064,12138,15
04-20-21,835952,1113,692415,915,143537,198,797570,6720272,7517842,13985,15,12111,-242,11238,1340,812603,45,21044,12123,7
04-19-21,834839,848,691500,549,143339,299,796585,6707272,7503857,9282,15,12096,-682,11480,1515,811263,37,20999,12116,11
04-18-21,833991,562,690951,481,143040,81,795971,6698604,7494575,8187,17,12081,-161,12162,706,809748,16,20962,12105,10
04-17-21,833429,706,690470,574,142959,132,795392,6690996,7486388,11807,1,12064,-78,12323,783,809042,17,20946,12095,10
04-16-21,832723,4217,689896,3995,142827,222,794721,6679860,7474581,35546,14,12063,3247,12401,956,808259,37,20929,12085,6
04-15-21,828506,1377,685901,1000,142605,377,790020,6649015,7439035,18283,8,12049,158,9154,1211,807303,33,20892,12079,11
04-14-21,827129,1807,684901,1337,142228,470,788914,6631838,7420752,24938,9,12041,652,8996,1146,806092,36,20859,12068,11
04-13-21,825322,1139,683564,707,141758,432,787387,6608427,7395814,10970,10,12032,-99,8344,1228,804946,33,20823,12057,11
04-12-21,824183,1232,682857,882,141326,350,786629,6598215,7384844,9378,7,12022,-152,8443,1377,803718,30,20790,12046,15
04-11-21,822951,655,681975,461,140976,194,785632,6589834,7375466,7668,3,12015,-188,8595,840,802341,21,20760,12031,5
04-10-21,822296,873,681514,606,140782,267,785111,6582687,7367798,12240,8,12012,123,8783,742,801501,24,20739,12026,10
04-09-21,821423,1338,680908,1043,140515,295,784374,6571184,7355558,16481,3,12004,216,8660,1119,800759,35,20715,12016,13
04-08-21,820085,1150,679865,782,140220,368,783227,6555850,7339077,15056,4,12001,-49,8444,1195,799640,22,20680,12003,5
04-07-21,818935,1586,679083,1189,139852,397,782338,6541683,7324021,21235,21,11997,329,8493,1236,798445,34,20658,11998,8
04-06-21,817349,1337,677894,884,139455,453,781030,6521756,7302786,14562,9,11976,70,8164,1258,797209,26,20624,11990,5
04-05-21,816012,892,677010,516,139002,376,780023,6508201,7288224,6198,38,11967,-618,8094,1472,795951,42,20598,11985,10
04-04-21,815120,552,676494,415,138626,137,779469,6502557,7282026,9622,7,11929,-262,8712,807,794479,10,20556,11975,16
04-03-21,814568,896,676079,637,138489,259,778968,6493436,7272404,10432,0,11922,9,8974,887,793672,16,20546,11959,14
04-02-21,813672,1067,675442,810,138230,257,778242,6483730,7261972,14204,1,11922,-65,8965,1131,792785,17,20530,11945,11
04-01-21,812605,1254,674632,901,137973,353,777288,6470480,7247768,14416,6,11921,-190,9030,1438,791654,18,20513,11934,7
03-31-21,811351,1870,673731,1197,137620,673,776293,6457059,7233352,22841,11,11915,594,9220,1265,790216,29,20495,11927,11
03-30-21,809481,1193,672534,879,136947,314,774906,6435605,7210511,14242,10,11904,-101,8626,1284,788951,34,20466,11916,9
03-29-21,808288,1192,671655,615,136633,577,773883,6422386,7196269,8856,29,11894,-287,8727,1450,787667,25,20432,11907,6
03-28-21,807096,815,671040,566,136056,249,773142,6414271,7187413,10825,13,11865,-46,9014,848,786217,23,20407,11901,8
03-27-21,806281,814,670474,744,135807,70,772493,6404095,7176588,13029,11,11852,3,9060,800,785369,22,20384,11893,9
03-26-21,805467,998,669730,800,135737,198,771587,6391972,7163559,11726,25,11841,-240,9057,1213,784569,14,20362,11884,15
03-25-21,804469,1146,668930,871,135539,275,770735,6381098,7151833,16338,20,11816,-107,9297,1233,783356,35,20348,11869,6
03-24-21,803323,1610,668059,1279,135264,331,769754,6365741,7135495,21274,4,11796,381,9404,1225,782123,28,20313,11863,6
03-23-21,801713,1173,666780,723,134933,450,768391,6345830,7114221,14489,45,11792,-131,9023,1259,780898,33,20285,11857,12
03-22-21,800540,1267,666057,808,134483,459,767578,6332154,7099732,9718,34,11747,-54,9154,1287,779639,35,20252,11845,13
03-21-21,799273,757,665249,562,134024,195,766648,6323366,7090014,8881,8,11713,-9,9208,758,778352,7,20217,11832,13
03-20-21,798516,755,664687,518,133829,237,766027,6315106,7081133,9696,4,11705,-24,9217,775,777594,17,20210,11819,7
03-19-21,797761,1943,664169,1287,133592,656,765470,6305967,7071437,22137,28,11701,758,9241,1157,776819,32,20193,11812,11
03-18-21,795818,1415,662882,965,132936,450,764054,6285246,7049300,18715,23,11673,277,8483,1115,775662,42,20161,11801,14
03-17-21,794403,1073,661917,826,132486,247,762934,6267651,7030585,15441,8,11650,-81,8206,1146,774547,24,20119,11787,19
03-16-21,793330,1939,661091,1248,132239,691,762034,6253110,7015144,19037,12,11642,727,8287,1200,773401,50,20095,11768,9
03-15-21,791391,903,659843,498,131548,405,760589,6235518,6996107,5278,11,11630,-247,7560,1139,772201,24,20045,11759,8
03-14-21,790488,663,659345,461,131143,202,760041,6230788,6990829,8041,0,11619,-91,7807,754,771062,17,20021,11751,15
03-13-21,789825,1486,658884,802,130941,684,759485,6223303,6982788,16650,-12,11619,604,7898,894,770308,22,20004,11736,12
03-12-21,788339,1114,658082,841,130257,273,758549,6207589,6966138,13855,16,11631,-17,7294,1115,769414,13,19982,11724,19
03-11-21,787225,1368,657241,923,129984,445,757546,6194737,6952283,19248,17,11615,171,7311,1180,768299,15,19969,11705,12
03-10-21,785857,1602,656318,1136,129539,466,756517,6176518,6933035,23679,18,11598,303,7140,1281,767119,30,19954,11693,25
03-09-21,784255,1350,655182,806,129073,544,755240,6154116,6909356,17108,32,11580,-37,6837,1355,765838,24,19924,11668,21
03-08-21,782905,1089,654376,677,128529,412,754290,6137958,6892248,7646,9,11548,-554,6874,1634,764483,15,19900,11647,26
03-07-21,781816,753,653699,473,128117,280,753516,6131086,6884602,7138,4,11539,-198,7428,947,762849,9,19885,11621,23
03-06-21,781063,1237,653226,843,127837,394,752940,6124524,6877464,18288,9,11535,173,7626,1055,761902,20,19876,11598,20
03-05-21,779826,1227,652383,780,127443,447,751913,6107263,6859176,14118,33,11526,-68,7453,1262,760847,14,19856,11578,19
03-04-21,778599,1609,651603,1066,126996,543,750997,6094061,6845058,25299,42,11493,570,7521,997,759585,27,19842,11559,18
03-03-21,776990,1309,650537,883,126453,426,749705,6070054,6819759,18081,23,11451,19,6951,1267,758588,22,19815,11541,23
03-02-21,775681,1552,649654,983,126027,569,748672,6053006,6801678,16000,15,11428,529,6932,1008,757321,32,19793,11518,11
03-01-21,774129,569,648671,359,125458,210,747499,6038179,6785678,3825,10,11413,-432,6403,991,756313,16,19761,11507,14
02-28-21,773560,841,648312,582,125248,259,747101,6034752,6781853,10209,18,11403,-69,6835,892,755322,11,19745,11493,13
02-27-21,772719,1438,647730,855,124989,583,746420,6025224,6771644,18087,16,11385,375,6904,1047,754430,23,19734,11480,16
02-26-21,771281,1131,646875,794,124406,337,745381,6008176,6753557,11962,56,11369,-560,6529,1635,753383,16,19711,11464,11
02-25-21,770150,1682,646081,1175,124069,507,744455,5997140,6741595,22430,55,11313,-97,7089,1724,751748,37,19695,11453,23
02-24-21,768468,1923,644906,1476,123562,447,743098,5976067,6719165,24679,68,11258,-40,7186,1895,750024,39,19658,11430,19
02-23-21,766545,1846,643430,1127,123115,719,741367,5953119,6694486,16868,45,11190,-375,7226,2176,748129,44,19619,11411,21
02-22-21,764699,1057,642303,601,122396,456,740125,5937493,6677618,6162,20,11145,-1276,7601,2313,745953,37,19575,11390,23
02-21-21,763642,872,641702,583,121940,289,739423,5932033,6671456,6860,18,11125,-273,8877,1127,743640,15,19538,11367,30
02-20-21,762770,1366,641119,836,121651,530,738721,5925875,6664596,12464,51,11107,-58,9150,1373,742513,31,19523,11337,20
02-19-21,761404,998,640283,643,121121,355,737807,5914325,6652132,6668,7,11056,-925,9208,1916,741140,37,19492,11317,29
02-18-21,760406,1486,639640,952,120766,534,737072,5908392,6645464,12981,72,11049,-646,10133,2060,739224,42,19455,11288,30
02-17-21,758920,932,638688,596,120232,336,735992,5896491,6632483,6597,31,10977,-1298,10779,2199,737164,16,19413,11258,38
02-16-21,757988,1232,638092,784,119896,448,735306,5890580,6625886,9891,17,10946,-1244,12077,2459,734965,30,19397,11220,31
02-15-21,756756,780,637308,454,119448,326,734416,5881579,6615995,6227,4,10929,-2025,13321,2801,732506,12,19367,11189,26
02-14-21,755976,1255,636854,899,119122,356,733889,5875879,6609768,13046,31,10925,-355,15346,1579,729705,23,19355,11163,31
02-13-21,754721,1678,635955,1120,118766,558,732840,5863882,6596722,19167,9,10894,14,15701,1655,728126,30,19332,11132,33
02-12-21,753043,1928,634835,1382,118208,546,731505,5846050,6577555,22324,81,10885,-394,15687,2241,726471,21,19302,11099,27
02-11-21,751115,2421,633453,1739,117662,682,729879,5825352,6555231,25279,81,10804,-274,16081,2614,724230,35,19281,11072,34
02-10-21,748694,2141,631714,1518,116980,623,727886,5802066,6529952,24637,100,10723,-578,16355,2619,721616,39,19246,11038,37
02-09-21,746553,2701,630196,1781,116357,920,726111,5779204,6505315,21681,65,10623,-585,16933,3221,718997,57,19207,11001,40
02-08-21,743852,1251,628415,787,115437,464,723975,5759659,6483634,6680,97,10558,-2325,17518,3479,715776,30,19150,10961,36
02-07-21,742601,1354,627628,940,114973,414,723061,5753893,6476954,12767,6,10461,-435,19843,1783,712297,27,19120,10925,26
02-06-21,741247,3663,626688,2593,114559,1070,722020,5742167,6464187,39535,58,10455,1597,20278,2008,710514,44,19093,10899,58
02-05-21,737584,2184,624095,1569,113489,615,718761,5705891,6424652,22624,203,10397,-768,18681,2749,708506,53,19049,10841,50
02-04-21,735400,2897,622526,2081,112874,816,716818,5685210,6402028,32437,169,10194,-545,19449,3273,705757,69,18996,10791,49
02-03-21,732503,3352,620445,2254,112058,1098,714465,5655126,6369591,27517,133,10025,33,19994,3186,702484,87,18927,10742,40
02-02-21,729151,1315,618191,837,110960,478,711893,5630181,6342074,6562,147,9892,-2880,19961,4048,699298,25,18840,10702,43
02-01-21,727836,1692,617354,1052,110482,640,710988,5624524,6335512,8145,103,9745,-1894,22841,3483,695250,50,18815,10659,51
01-31-21,726144,2176,616302,1382,109842,794,709837,5617530,6327367,17538,76,9642,-1,24735,2101,691767,48,18765,10608,48
01-30-21,723968,3524,614920,2946,109048,578,708109,5601720,6309829,38108,113,9566,805,24736,2606,689666,50,18717,10560,50
01-29-21,720444,1766,611974,1238,108470,528,704582,5567139,6271721,13890,44,9453,-1900,23931,3622,687060,36,18667,10510,55
01-28-21,718678,3963,610736,2019,107942,1944,703084,5554747,6257831,20462,101,9409,-352,25831,4214,683438,82,18631,10455,70
01-27-21,714715,2728,608717,2066,105998,662,700816,5536553,6237369,20358,154,9308,-1246,26183,3820,679224,59,18549,10385,62
01-26-21,711987,3140,606651,2322,105336,818,698527,5518484,6217011,22545,192,9154,-1949,27429,4897,675404,72,18490,10323,82
01-25-21,708847,1822,604329,1221,104518,601,695934,5498532,6194466,11642,111,8962,-3560,29378,5271,670507,52,18418,10241,76
01-24-21,707025,1599,603108,1308,103917,291,694556,5488268,6182824,13243,40,8851,-1658,32938,3217,665236,40,18366,10165,82
01-23-21,705426,4488,601800,3170,103626,1318,693034,5476547,6169581,38169,42,8811,1106,34596,3340,662019,88,18326,10083,73
01-22-21,700938,2638,598630,1967,102308,671,688984,5442428,6131412,21626,93,8769,-2521,33490,5066,658679,52,18238,10010,74
01-21-21,698300,4713,596663,3509,101637,1204,686701,5423085,6109786,31119,128,8676,-1948,36011,6533,653613,82,18186,9936,107
01-20-21,693587,3115,593154,2096,100433,1019,682749,5395918,6078667,19977,86,8548,-2772,37959,5801,647080,57,18104,9829,86
01-19-21,690472,4774,591058,2772,99414,2002,680301,5378389,6058690,22859,40,8462,-3157,40731,7891,641279,111,18047,9743,99
01-18-21,685698,1617,588286,1068,97412,549,676976,5358855,6035831,7863,39,8422,-7213,43888,8791,633388,42,17936,9644,80
01-17-21,684081,2569,587218,1875,96863,694,675885,5352083,6027968,15257,36,8383,-1883,51101,4416,624597,52,17894,9564,90
01-16-21,681512,6935,585343,5347,96169,1588,673817,5338894,6012711,46124,44,8347,1314,52984,5577,620181,122,17842,9474,89
01-15-21,674577,2761,579996,1813,94581,948,667295,5299292,5966587,14582,79,8303,-667,51670,3349,614604,58,17720,9385,90
01-14-21,671816,6158,578183,4797,93633,1361,665318,5286687,5952005,37433,84,8224,-280,52337,6354,611255,98,17662,9295,106
01-13-21,665658,4120,573386,2877,92272,1243,659760,5254812,5914572,20740,137,8140,-4020,52617,8003,604901,65,17564,9189,77
01-12-21,661538,4749,570509,3008,91029,1741,656750,5237082,5893832,20608,146,8003,-5992,56637,10595,596898,75,17499,9112,98
01-11-21,656789,3787,567501,2679,89288,1108,653495,5219729,5873224,14872,80,7857,-6336,62629,10043,586303,77,17424,9014,102
01-10-21,653002,5382,564822,3698,88180,1684,650563,5207789,5858352,29950,81,7777,1032,68965,4269,576260,84,17347,8912,107
01-09-21,647620,7223,561124,5752,86496,1471,645947,5182455,5828402,39412,86,7696,2006,67933,5131,571991,88,17263,8805,89
01-08-21,640397,6054,555372,4577,85025,1477,639241,5149749,5788990,33879,126,7610,4241,65927,1687,566860,96,17175,8716,118
01-07-21,634343,7345,550795,6305,83548,1040,633262,5121849,5755111,33694,111,7484,3156,61686,4078,565173,99,17079,8598,91
01-06-21,626998,7363,544490,5162,82508,2201,626893,5094524,5721417,28877,114,7373,442,58530,6807,561095,129,16980,8507,115
01-05-21,619635,8411,539328,5142,80307,3269,621361,5071179,5692540,25835,99,7259,-772,58088,9084,554288,129,16851,8392,115
01-04-21,611224,4054,534186,3003,77038,1051,616034,5050671,5666705,10898,143,7160,-4617,58860,8528,545204,67,16722,8277,107
01-03-21,607170,3515,531183,2375,75987,1140,613056,5042751,5655807,12412,55,7017,-262,63477,3722,536676,56,16655,8170,103
01-02-21,603655,7202,528808,5733,74847,1469,610607,5032788,5643395,30052,15,6962,3107,63739,4080,532954,99,16599,8067,86
01-01-21,596453,6683,523075,5229,73378,1454,604031,5009312,5613343,28072,48,6947,-423,60632,7058,528874,76,16500,7981,98
12-31-20,589770,9175,517846,7235,71924,1940,598424,4986847,5585271,35514,97,6899,1906,61055,7172,521816,74,16424,7883,99
12-30-20,580595,6703,510611,4532,69984,2171,590339,4959418,5549757,22254,100,6802,-745,59149,7348,514644,81,16350,7784,99
12-29-20,573892,8082,506079,4952,67813,3130,585395,4942108,5527503,23338,122,6702,27,59894,7933,507296,115,16269,7685,98
12-28-20,565810,3549,501127,2632,64683,917,580070,4924095,5504165,10183,76,6580,-6636,59867,10109,499363,78,16154,7587,89
12-27-20,562261,3379,498495,2294,63766,1085,577218,4916764,5493982,13197,69,6504,-457,66503,3767,489254,76,16076,7498,87
12-26-20,558882,4890,496201,3547,62681,1343,574432,4906353,5480785,21744,7,6435,823,66960,4060,485487,86,16000,7411,92
12-25-20,553992,6630,492654,5438,61338,1192,570550,4888491,5459041,33415,5,6428,-606,66137,7231,481427,54,15914,7319,81
12-24-20,547362,6646,487216,5030,60146,1616,564519,4861107,5425626,32449,51,6423,-571,66743,7166,474196,46,15860,7238,106
12-23-20,540716,6097,482186,3970,58530,2127,558792,4834385,5393177,26396,111,6372,-1371,67314,7357,467030,84,15814,7132,97
12-22-20,534619,6914,478216,4717,56403,2197,554215,4812566,5366781,29092,133,6261,-857,68685,7638,459673,125,15730,7035,109
12-21-20,527705,5826,473499,4381,54206,1445,548932,4788757,5337689,26620,65,6128,-3977,69542,9738,452035,83,15605,6926,104
12-20-20,521879,10057,469118,8397,52761,1660,544037,4767032,5311069,61067,54,6063,6472,73519,3531,442297,106,15522,6822,101
12-19-20,511822,7127,460721,6080,51101,1047,534471,4715531,5250002,41320,57,6009,3219,67047,3851,438766,71,15416,6721,93
12-18-20,504695,8318,454641,7029,50054,1289,527069,4681613,5208682,40593,115,5952,1884,63828,6319,434915,93,15345,6628,96
12-17-20,496377,10223,447612,8115,48765,2108,519625,4648464,5168089,44542,177,5837,3178,61944,6868,428596,115,15252,6532,92
12-16-20,486154,9377,439497,6519,46657,2858,510958,4612589,5123547,35802,53,5660,2291,58766,7033,421728,145,15137,6440,85
12-15-20,476777,11905,432978,10386,43799,1519,503840,4583905,5087745,65214,74,5607,4646,56475,7185,414695,158,14992,6355,66
12-14-20,464872,7985,422592,6909,42280,1076,492132,4530399,5022531,42299,79,5533,-2529,51829,10435,407510,112,14834,6289,76
12-13-20,456887,11295,415683,9908,41204,1387,484363,4495869,4980232,68970,62,5454,7818,54358,3415,397075,125,14722,6213,85
12-12-20,445592,8985,405775,7346,39817,1639,473288,4437974,4911262,47612,73,5392,5083,46540,3829,393660,136,14597,6128,80
12-11-20,436607,6081,398429,5144,38178,937,464991,4398659,4863650,32160,87,5319,1740,41457,4254,389831,116,14461,6048,68
12-10-20,430526,8935,393285,7807,37241,1128,459374,4372116,4831490,52303,69,5232,7598,39717,1268,385577,122,14345,5980,75
12-09-20,421591,5825,385478,5138,36113,687,450575,4328612,4779187,27608,62,5163,158,32119,5605,384309,100,14223,5905,62
12-08-20,415766,8105,380340,7025,35426,1080,444939,4306640,4751579,45066,100,5101,2332,31961,5673,378704,105,14123,5843,79
12-07-20,407661,7163,373315,6156,34346,1007,437228,4269285,4706513,35778,66,5001,-730,29629,7827,373031,87,14018,5764,72
12-06-20,400498,4061,367159,3420,33339,641,430553,4240182,4670735,19691,38,4935,1162,30359,2861,365204,46,13931,5692,86
12-05-20,396437,3073,363739,2522,32698,551,426809,4224235,4651044,15631,29,4897,9,29197,3035,362343,51,13885,5606,78
12-04-20,393364,5393,361217,4316,32147,1077,424128,4211285,4635413,27003,95,4868,-328,29188,5626,359308,94,13834,5528,83
12-03-20,387971,4821,356901,4010,31070,811,419276,4189134,4608410,25644,93,4773,576,29516,4152,353682,81,13740,5445,72
12-02-20,383150,2515,352891,2121,30259,394,414798,4167968,4582766,11857,50,4680,-2568,28940,5033,349530,61,13659,5373,67
12-01-20,380635,6708,350770,5709,29865,999,412640,4158269,4570909,36185,36,4630,1055,31508,5617,344497,110,13598,5306,68
11-30-20,373927,6009,345061,5434,28866,575,406489,4128235,4534724,40767,48,4594,-1182,30453,7143,338880,89,13488,5238,80
11-29-20,367918,5543,339627,5113,28291,430,400488,4093469,4493957,37944,13,4546,2509,31635,3021,331737,72,13399,5158,58
11-28-20,362375,4732,334514,4104,27861,628,394760,4061253,4456013,31938,15,4533,1636,29126,3081,328716,75,13327,5100,62
11-27-20,357643,5441,330410,4849,27233,592,390163,4033912,4424075,32651,7,4518,419,27490,5015,325635,81,13252,5038,80
11-26-20,352202,5303,325561,4941,26641,362,384601,4006823,4391424,52396,53,4511,-438,27071,5688,320620,60,13171,4958,47
11-25-20,346899,2184,320620,1583,26279,601,378714,3960314,4339028,12063,92,4458,-2390,27509,4482,314932,91,13111,4911,64
11-24-20,344715,2060,319037,1522,25678,538,377266,3949699,4326965,10737,73,4366,-3444,29899,5431,310450,91,13020,4847,66
11-23-20,342655,2216,317515,1854,25140,362,375759,3940469,4316228,11119,35,4293,-4680,33343,6861,305019,70,12929,4781,69
11-22-20,340439,5570,315661,5065,24778,505,373887,3931222,4305109,43868,55,4258,2916,38023,2599,298158,111,12859,4712,59
11-21-20,334869,3429,310596,2908,24273,521,368187,3893054,4261241,25935,9,4203,802,35107,2618,295559,81,12748,4653,74
11-20-20,331440,4053,307688,3537,23752,516,365025,3870281,4235306,24344,74,4194,-38,34305,4017,292941,66,12667,4579,67
11-19-20,327387,3004,304151,2287,23236,717,361191,3849771,4210962,16865,80,4120,-1359,34343,4283,288924,81,12601,4512,57
11-18-20,324383,4045,301864,3055,22519,990,358756,3835341,4194097,24020,53,4040,-93,35702,4085,284641,96,12520,4455,43
11-17-20,320338,3507,298809,3183,21529,324,355302,3814775,4170077,21243,72,3987,-128,35795,3563,280556,66,12424,4412,68
11-16-20,316831,4656,295626,4245,21205,411,351738,3797096,4148834,35167,30,3915,-74,35923,4700,276993,78,12358,4344,51
11-15-20,312175,6473,291381,5859,20794,614,347082,3766585,4113667,55527,16,3885,4526,35997,1931,272293,111,12280,4293,48
11-14-20,305702,4900,285522,4462,20180,438,340462,3717678,4058140,38286,25,3869,3071,31471,1804,270362,85,12169,4245,60
11-13-20,300802,4375,281060,3755,19742,620,335436,3684418,4019854,27169,64,3844,1537,28400,2774,268558,70,12084,4185,43
11-12-20,296427,3147,277305,2576,19122,571,331433,3661252,3992685,19299,27,3780,410,26863,2710,265784,55,12014,4142,36
11-11-20,293280,3928,274729,3304,18551,624,328690,3644696,3973386,28178,89,3753,990,26453,2849,263074,72,11959,4106,50
11-10-20,289352,3033,271425,2493,17927,540,324853,3620355,3945208,25726,62,3664,93,25463,2878,260225,83,11887,4056,50
11-09-20,286319,2384,268932,2053,17387,331,322087,3597395,3919482,19718,15,3602,-881,25370,3250,257347,43,11804,4006,42
11-08-20,283935,5408,266879,4866,17056,542,319785,3579979,3899764,55010,5,3587,3588,26251,1815,254097,89,11761,3964,40
11-07-20,278527,4188,262013,3856,16514,332,314248,3530506,3844754,43217,49,3582,2265,22663,1874,252282,87,11672,3924,33
11-06-20,274339,3602,258157,3027,16182,575,309735,3491802,3801537,28586,32,3533,953,20398,2617,250408,62,11585,3891,47
11-05-20,270737,1405,255130,1110,15607,295,306365,3466586,3772951,10920,31,3501,-1314,19445,2688,247791,52,11523,3844,40
11-04-20,269332,2648,254020,2347,15312,301,305148,3456883,3762031,23448,24,3470,-166,20759,2790,245103,68,11471,3804,50
11-03-20,266684,3019,251673,2715,15011,304,302537,3436046,3738583,24960,75,3446,235,20925,2709,242313,54,11403,3754,45
11-02-20,263665,1903,248958,1779,14707,124,299480,3414143,3713623,16695,26,3371,-1340,20690,3217,239604,64,11349,3709,38
11-01-20,261762,2483,247179,2118,14583,365,297529,3399399,3696928,34033,0,3345,775,22030,1708,236387,64,11285,3671,32
10-31-20,259279,149,245061,137,14218,12,295030,3367865,3662895,807,12,3345,-1542,21255,1679,234679,2,11221,3639,29
10-30-20,259130,2405,244924,2186,14206,219,294891,3367197,3662088,22327,78,3333,91,22797,2236,233000,62,11219,3610,40
10-29-20,256725,2374,242738,2040,13987,334,292556,3347205,3639761,25466,22,3255,29,22706,2323,230764,66,11157,3570,38
10-28-20,254351,2678,240698,2391,13653,287,290260,3324035,3614295,23114,34,3233,139,22677,2505,228441,67,11091,3532,38
10-27-20,251673,2446,238307,2039,13366,407,287625,3303556,3591181,22838,44,3199,-16,22538,2418,225936,101,11024,3494,46
10-26-20,249227,1507,236268,1319,12959,188,285335,3283008,3568343,11258,32,3155,-1380,22554,2855,223518,45,10923,3448,31
10-25-20,247720,3085,234949,2897,12771,188,283887,3273198,3557085,35758,31,3123,1586,23934,1468,220663,82,10878,3417,42
10-24-20,244635,3609,232052,3313,12583,296,280409,3240918,3521327,39876,24,3092,1919,22348,1666,219195,85,10796,3375,45
10-23-20,241026,2655,228739,2404,12287,251,276590,3204861,3481451,29993,65,3068,504,20429,2086,217529,73,10711,3330,33
10-22-20,238371,3183,226335,2830,12036,353,273920,3177538,3451458,35909,41,3003,1134,19925,2008,215443,90,10638,3297,28
10-21-20,235188,1734,223505,1487,11683,247,270715,3144834,3415549,15344,18,2962,-530,18791,2246,213435,44,10548,3269,38
10-20-20,233454,1967,222018,1682,11436,285,269001,3131204,3400205,18701,30,2944,-77,19321,2014,211189,60,10504,3231,37
10-19-20,231487,2190,220336,1996,11151,194,266976,3114528,3381504,20252,13,2914,-175,19398,2352,209175,91,10444,3194,33
10-18-20,229297,2637,218340,2462,10957,175,264936,3096316,3361252,39723,6,2901,1327,19573,1304,206823,73,10353,3161,21
10-17-20,226660,2684,215878,2478,10782,206,262025,3059504,3321529,36781,32,2895,1307,18246,1345,205519,75,10280,3140,27
10-16-20,223976,1719,213400,1526,10576,193,259037,3025711,3284748,16347,7,2863,-138,16939,1850,204174,44,10205,3113,29
10-15-20,222257,1425,211874,1220,10383,205,257466,3010935,3268401,16243,36,2856,-326,17077,1715,202324,52,10161,3084,41
10-14-20,220832,2312,210654,2109,10178,203,256123,2996035,3252158,22128,31,2820,566,17403,1715,200609,68,10109,3043,37
10-13-20,218520,1544,208545,1268,9975,276,253914,2976116,3230030,16119,23,2789,-15,16837,1536,198894,54,10041,3006,36
10-12-20,216976,1232,207277,1049,9699,183,252472,2961439,3213911,15371,7,2766,-825,16852,2050,197358,43,9987,2970,36
10-11-20,215744,2950,206228,2748,9516,202,251268,2947272,3198540,42924,9,2759,1854,17677,1087,195308,92,9944,2934,28
10-10-20,212794,1886,203480,1778,9314,108,248114,2907502,3155616,29452,26,2750,837,15823,1023,194221,51,9852,2906,29
10-09-20,210908,1418,201702,1246,9206,172,246088,2880076,3126164,26240,27,2724,54,14986,1337,193198,41,9801,2877,26
10-08-20,209490,2003,200456,1813,9034,190,244679,2855245,3099924,25617,63,2697,537,14932,1403,191861,67,9760,2851,26
10-07-20,207487,1842,198643,1575,8844,267,242742,2831565,3074307,23391,21,2634,351,14395,1470,190458,74,9693,2825,28
10-06-20,205645,1999,197068,1700,8577,299,240999,2809917,3050916,25403,24,2613,447,14044,1528,188988,91,9619,2797,27
10-05-20,203646,2217,195368,2003,8278,214,239034,2786479,3025513,35568,20,2589,369,13597,1828,187460,90,9528,2770,25
10-04-20,201429,1820,193365,1666,8064,154,236538,2753407,2989945,38328,17,2569,885,13228,918,185632,67,9438,2745,29
10-03-20,199609,1356,191699,1244,7910,112,234349,2717268,2951617,29131,45,2552,341,12343,970,184714,44,9371,2716,18
10-02-20,198253,1206,190455,1065,7798,141,232754,2689732,2922486,15628,14,2507,-297,12002,1489,183744,43,9327,2698,22
10-01-20,197047,1149,189390,1008,7657,141,231468,2675390,2906858,18504,47,2493,-308,12299,1410,182255,51,9284,2676,21
09-30-20,195898,1429,188382,1253,7516,176,230279,2658075,2888354,13516,34,2446,-87,12607,1482,180845,36,9233,2655,26
09-29-20,194469,1191,187129,975,7340,216,228813,2646025,2874838,20750,31,2412,-293,12694,1453,179363,63,9197,2629,14
09-28-20,193278,678,186154,547,7124,131,227513,2626575,2854088,8425,12,2381,-1227,12987,1893,177910,32,9134,2615,26
09-27-20,192600,1367,185607,1277,6993,90,226801,2618862,2845663,29532,3,2369,436,14214,928,176017,54,9102,2589,24
09-26-20,191233,2122,184330,1980,6903,142,225254,2590877,2816131,44232,22,2366,1032,13778,1068,175089,60,9048,2565,23
09-25-20,189111,1345,182350,1246,6761,99,222770,2549129,2771899,26157,42,2344,-119,12746,1422,174021,48,8988,2542,23
09-24-20,187766,1400,181104,1231,6662,169,221252,2524490,2745742,27201,35,2302,-104,12865,1469,172599,51,8940,2519,20
09-23-20,186366,917,179873,799,6493,118,219740,2498801,2718541,9438,14,2267,-627,12969,1530,171130,25,8889,2499,28
09-22-20,185449,1645,179074,1422,6375,223,218806,2490297,2709103,25552,28,2253,-182,13596,1799,169600,56,8864,2471,20
09-21-20,183804,668,177652,522,6152,146,216907,2466644,2683551,7093,15,2225,-394,13778,1047,167801,40,8808,2451,20
09-20-20,183136,1029,177130,915,6006,114,216198,2460260,2676458,20448,2,2210,139,14172,888,166754,38,8768,2431,26
09-19-20,182107,2137,176215,2036,5892,101,214994,2441016,2656010,48406,20,2208,1213,14033,904,165866,82,8730,2405,18
09-18-20,179970,1504,174179,1333,5791,171,212482,2395122,2607604,30080,32,2188,-312,12820,1784,164962,49,8648,2387,28
09-17-20,178466,1827,172846,1686,5620,141,210787,2366737,2577524,27800,13,2156,427,13132,1387,163178,54,8599,2359,26
09-16-20,176639,1063,171160,926,5479,137,208743,2340981,2549724,16767,24,2143,-377,12705,1416,161791,41,8545,2333,21
09-15-20,175576,1911,170234,1686,5342,225,207550,2325407,2532957,34224,30,2119,308,13082,1573,160375,68,8504,2312,17
09-14-20,173665,1601,168548,1436,5117,165,205267,2293466,2498733,22962,19,2089,-73,12774,1655,158802,78,8436,2295,27
09-13-20,172064,1400,167112,1315,4952,85,203480,2272291,2475771,22930,14,2070,389,12847,997,157147,44,8358,2268,14
09-12-20,170664,1334,165797,1257,4867,77,201787,2251054,2452841,26749,39,2056,466,12458,829,156150,42,8314,2254,35
09-11-20,169330,1008,164540,894,4790,114,200132,2225960,2426092,14962,37,2017,-1370,11992,2341,155321,40,8272,2219,28
09-10-20,168322,2002,163646,1823,4676,179,199016,2212114,2411130,31632,57,1980,513,13362,1432,152980,76,8232,2191,23
09-09-20,166320,1153,161823,1046,4497,107,196779,2182719,2379498,17736,35,1923,-338,12849,1456,151548,56,8156,2168,23
09-08-20,165167,818,160777,708,4390,110,195433,2166329,2361762,13091,27,1888,-754,13187,1545,150092,47,8100,2145,25
09-07-20,164349,783,160069,736,4280,47,194576,2154095,2348671,8061,4,1861,-963,13941,1742,148547,33,8053,2120,17
09-06-20,163566,828,159333,775,4233,53,193439,2147171,2340610,12311,3,1857,-62,14904,887,146805,38,8020,2103,35
09-05-20,162738,2561,158558,2491,4180,70,192526,2135773,2328299,35069,25,1854,1527,14966,1009,145918,48,7982,2068,21
09-04-20,160177,1118,156067,1038,4110,80,189600,2103630,2293230,13468,22,1829,-158,13439,1254,144909,46,7934,2047,21
09-03-20,159059,1658,155029,1515,4030,143,188412,2091350,2279762,28417,18,1807,22,13597,1618,143655,56,7888,2026,22
09-02-20,157401,1190,153514,1082,3887,108,186515,2064830,2251345,16475,16,1789,-328,13575,1502,142037,53,7832,2004,23
09-01-20,156211,1700,152432,1536,3779,164,185274,2049596,2234870,22896,27,1773,116,13903,1557,140535,66,7779,1981,22
08-31-20,154511,1247,150896,1177,3615,70,183291,2028683,2211974,12933,7,1746,-350,13787,1590,138978,39,7713,1959,24
08-30-20,153264,1462,149719,1428,3545,34,181875,2017166,2199041,8728,22,1739,525,14137,915,137388,34,7674,1935,16
08-29-20,151802,1534,148291,1425,3511,109,180270,2010043,2190313,25361,24,1717,365,13612,1145,136473,51,7640,1919,25
08-28-20,150268,1128,146866,1074,3402,54,178482,1986470,2164952,12674,28,1693,-482,13247,1582,135328,43,7589,1894,23
08-27-20,149140,2334,145792,2211,3348,123,177209,1975069,2152278,37154,25,1665,903,13729,1406,133746,67,7546,1871,25
08-26-20,146806,1325,143581,1209,3225,116,174489,1940635,2115124,18264,20,1640,-397,12826,1702,132340,56,7479,1846,30
08-25-20,145481,1713,142372,1595,3109,118,172947,1923913,2096860,30311,40,1620,115,13223,1558,130638,68,7423,1816,24
08-24-20,143768,645,140777,532,2991,113,170945,1895604,2066549,7173,21,1580,-1405,13108,2029,129080,41,7355,1792,35
08-23-20,143123,815,140245,751,2878,64,170237,1889139,2059376,14428,4,1559,-206,14513,1017,127051,42,7314,1757,24
08-22-20,142308,2437,139494,2374,2814,63,169321,1875627,2044948,52018,14,1555,1242,14719,1181,126034,71,7272,1733,17
08-21-20,139871,528,137120,485,2751,43,166390,1826540,1992930,10322,61,1541,-1227,13477,1694,124853,31,7201,1716,20
08-20-20,139343,2446,136635,2272,2708,174,165828,1816780,1982608,42968,36,1480,752,14704,1658,123159,84,7170,1696,20
08-19-20,136897,1346,134363,1280,2534,66,163021,1776619,1939640,20202,26,1444,-542,13952,1862,121501,55,7086,1676,22
08-18-20,135551,1784,133083,1664,2468,120,161461,1757977,1919438,37974,39,1418,-206,14494,1951,119639,63,7031,1654,16
08-17-20,133767,854,131419,716,2348,138,158980,1722484,1881464,9314,21,1379,-1301,14700,2134,117688,57,6968,1638,19
08-16-20,132913,1410,130703,1383,2210,27,158103,1714047,1872150,20013,21,1358,304,16001,1085,115554,42,6911,1619,30
08-15-20,131503,1944,129320,1858,2183,86,156301,1695836,1852137,27243,19,1337,600,15697,1325,114469,60,6869,1589,29
08-14-20,129559,1385,127462,1303,2097,82,153783,1671111,1824894,15148,13,1318,-342,15097,1714,113144,47,6809,1560,22
08-13-20,128174,2529,126159,2430,2015,99,152141,1657605,1809746,36811,24,1305,585,15439,1920,111430,123,6762,1538,24
08-12-20,125645,1256,123729,1215,1916,41,148785,1624150,1772935,13617,18,1281,-763,14854,2001,109510,59,6639,1514,24
08-11-20,124389,1812,122514,1698,1875,114,147403,1611915,1759318,24279,38,1263,-170,15617,1944,107509,77,6580,1490,26
08-10-20,122577,904,120816,852,1761,52,145225,1589814,1735039,8471,10,1225,-1483,15787,2377,105565,71,6503,1464,29
08-09-20,121673,1575,119964,1547,1709,28,144245,1582323,1726568,17499,8,1215,460,17270,1107,103188,50,6432,1435,14
08-08-20,120098,2112,118417,2049,1681,63,142341,1566728,1709069,33932,9,1207,944,16810,1159,102081,56,6382,1421,21
08-07-20,117986,1797,116368,1745,1618,52,139707,1535430,1675137,18558,20,1198,103,15866,1674,100922,102,6326,1400,25
08-06-20,116189,2743,114623,2630,1566,113,137546,1519033,1656579,32159,42,1178,989,15763,1712,99248,106,6224,1375,25
08-05-20,113446,1345,111993,1277,1453,68,134257,1490163,1624420,14155,27,1136,-666,14774,1984,97536,55,6118,1350,17
08-04-20,112101,1760,110716,1676,1385,84,132726,1477539,1610265,21043,25,1109,-386,15440,2121,95552,97,6063,1333,20
08-03-20,110341,1806,109040,1772,1301,34,130622,1458600,1589222,16897,19,1084,-707,15826,2494,93431,63,5966,1313,25
08-02-20,108535,1080,107268,1056,1267,24,128536,1443789,1572325,13182,6,1065,-73,16533,1147,90937,53,5903,1288,37
08-01-20,107455,2179,106212,2150,1243,29,127251,1431892,1559143,31973,7,1059,825,16606,1347,89790,67,5850,1251,23
07-31-20,105276,1754,104062,1705,1214,49,124457,1402713,1527170,18356,27,1052,-115,15781,1842,88443,68,5783,1228,27
07-30-20,103522,3593,102357,3550,1165,43,122503,1386311,1508814,43246,13,1025,1652,15896,1928,86601,138,5715,1201,29
07-29-20,99929,1185,98807,1156,1122,29,118118,1347450,1465568,9366,21,1012,-1252,14244,2416,84673,70,5577,1172,32
07-28-20,98744,2515,97651,2471,1093,44,116853,1339349,1456202,28754,21,991,131,15496,2363,82257,137,5507,1140,21
07-27-20,96229,1925,95180,1887,1049,38,113758,1313690,1427448,18056,11,970,-803,15365,2717,79894,107,5370,1119,17
07-26-20,94304,2329,93293,2276,1011,53,111493,1297899,1409392,26811,3,959,993,16168,1333,77177,80,5263,1102,21
07-25-20,91975,3102,91017,3062,958,40,108645,1273936,1382581,42424,26,956,1613,15175,1463,75844,117,5183,1081,20
07-24-20,88873,1864,87955,1818,918,46,104434,1235723,1340157,19351,13,930,-351,13562,2202,74381,99,5066,1061,28
07-23-20,87009,2547,86137,2498,872,49,102441,1218365,1320806,37692,37,917,398,13913,2112,72179,126,4967,1033,27
07-22-20,84462,2002,83639,1973,823,29,99218,1183896,1283114,17104,17,880,-465,13515,2450,70067,94,4841,1006,30
07-21-20,82460,3168,81666,3141,794,27,96918,1169092,1266010,39907,24,863,606,13980,2538,67617,155,4747,976,17
07-20-20,79292,1204,78525,1167,767,37,92998,1133105,1226103,9669,4,839,-1607,13374,2807,65079,54,4592,959,20
07-19-20,78088,1583,77358,1560,730,23,91679,1124755,1216434,18789,5,835,-18,14981,1596,62272,63,4538,939,16
07-18-20,76505,2133,75798,2111,707,22,89730,1107915,1197645,26482,23,830,826,14999,1284,60676,82,4475,923,17
07-17-20,74372,2133,73687,2088,685,45,87034,1084129,1171163,22074,19,807,517,14173,1597,59392,90,4393,906,16
07-16-20,72239,2977,71599,2934,640,43,84473,1064616,1149089,39896,13,788,1109,13656,1855,57795,115,4303,890,19
07-15-20,69262,1934,68665,1897,597,37,80594,1028599,1109193,19687,16,775,-124,12547,2042,55940,95,4188,871,17
07-14-20,67328,2123,66768,2081,560,42,78394,1011112,1089506,23626,18,759,214,12671,1891,53898,100,4093,854,11
07-13-20,65205,1831,64687,1800,518,31,75900,989980,1065880,17329,8,741,-101,12457,1924,52007,75,3993,843,19
07-12-20,63374,2324,62887,2299,487,25,73898,974653,1048551,28259,3,733,1220,12558,1101,50083,101,3918,824,17
07-11-20,61050,1179,60588,1165,462,14,71032,949260,1020292,15439,15,730,11,11338,1153,48982,51,3817,807,13
07-10-20,59871,1981,59423,1953,448,28,69479,935374,1004853,18338,13,715,566,11327,1402,47829,93,3766,794,17
07-09-20,57890,1807,57470,1780,420,27,67257,919258,986515,25176,25,702,374,10761,1408,46427,89,3673,777,17
07-08-20,56083,1654,55690,1629,393,25,65187,896152,961339,19200,20,677,60,10387,1574,45019,81,3584,760,12
07-07-20,54429,2154,54061,2144,368,10,63300,878839,942139,27249,12,657,719,10327,1423,43445,112,3503,748,18
07-06-20,52275,892,51917,878,358,14,60628,854262,914890,8255,7,645,-619,9608,1504,42022,60,3391,730,11
07-05-20,51383,1346,51039,1344,344,2,59707,846928,906635,15261,9,638,572,10227,765,40518,42,3331,719,18
07-04-20,50037,1461,49695,1459,342,2,58127,833247,891374,21507,4,629,625,9655,832,39753,57,3289,701,17
07-03-20,48576,1350,48236,1342,340,8,56262,813605,869867,16408,13,625,313,9030,1024,38921,55,3232,684,12
07-02-20,47226,1923,46894,1915,332,8,54768,798691,853459,26110,11,612,988,8717,924,37897,82,3177,672,9
07-01-20,45303,1429,44979,1424,324,5,52447,774902,827349,18374,5,601,465,7729,959,36973,61,3095,663,13
06-30-20,43874,1654,43555,1642,319,12,50739,758236,808975,25387,12,596,773,7264,869,36014,64,3034,650,12
06-29-20,42220,1787,41913,1780,307,7,48552,735036,783588,23019,0,584,795,6491,992,35145,89,2970,638,8
06-28-20,40433,655,40133,653,300,2,46534,714035,760569,10260,0,584,221,5696,434,34153,16,2881,630,8
06-27-20,39778,264,39480,258,298,6,45712,704597,750309,1850,7,584,-334,5475,591,33719,20,2865,622,8
06-26-20,39514,979,39222,955,292,24,45473,702986,748459,10321,10,577,290,5809,679,33128,59,2845,614,14
06-25-20,38535,1083,38267,1073,268,10,44454,693684,738138,14115,11,567,444,5519,628,32449,48,2786,600,9
06-24-20,37452,842,37194,834,258,8,43222,680801,724023,8465,14,556,121,5075,707,31821,48,2738,591,7
06-23-20,36610,1017,36360,1010,250,7,42240,673318,715558,11214,11,542,364,4954,642,31114,59,2690,584,5
06-22-20,35593,626,35350,614,243,12,41099,663245,704344,10540,5,531,-187,4590,808,30472,25,2631,579,6
06-21-20,34967,595,34736,594,231,1,40482,653322,693804,13748,2,526,202,4777,391,29664,21,2606,573,10
06-20-20,34372,409,34142,408,230,1,39637,640419,680056,9213,0,524,-61,4575,470,29273,24,2585,563,6
06-19-20,33963,745,33734,740,229,5,39089,631754,670843,10188,15,524,217,4636,513,28803,40,2561,557,9
06-18-20,33218,1098,32994,1096,224,2,38195,622460,660655,15629,12,509,499,4419,587,28290,70,2521,548,5
06-17-20,32120,409,31898,405,222,4,36941,608085,645026,5429,4,497,-221,3920,626,27703,22,2451,543,10
06-16-20,31711,614,31493,611,218,3,36520,603077,639597,7444,10,493,140,4141,464,27077,37,2429,533,6
06-15-20,31097,712,30882,699,215,13,35870,596283,632153,10494,8,483,20,4001,684,26613,37,2392,527,15
06-14-20,30385,607,30183,602,202,5,35063,586596,621659,13778,3,475,258,3981,346,25929,26,2355,512,9
06-13-20,29778,541,29581,536,197,5,34324,573557,607881,10695,4,472,159,3723,378,25583,21,2329,503,7
06-12-20,29237,546,29045,543,192,3,33593,563593,597186,9634,27,468,-43,3564,562,25205,31,2308,496,4
06-11-20,28691,615,28502,612,189,3,32970,554582,587552,9567,5,441,-159,3607,769,24643,26,2277,492,5
06-10-20,28076,427,27890,422,186,5,32270,545715,577985,8290,1,436,-181,3766,607,23874,40,2251,487,1
06-09-20,27649,585,27468,580,181,5,31898,537797,569695,9611,14,435,-49,3947,620,23267,38,2211,486,4
06-08-20,27064,489,26888,485,176,4,31225,528859,560084,9958,3,421,98,3996,388,22647,27,2173,482,5
06-07-20,26575,428,26403,426,172,2,30669,519457,550126,13934,1,418,157,3898,270,22259,22,2146,477,5
06-06-20,26147,471,25977,468,170,3,30048,506144,536192,10919,9,417,190,3741,272,21989,21,2124,472,10
06-05-20,25676,511,25509,502,167,9,29482,495791,525273,11818,7,408,8,3551,496,21717,20,2103,462,6
06-04-20,25165,227,25007,224,158,3,28869,484586,513455,5710,13,401,-265,3543,479,21221,19,2083,456,3
06-03-20,24938,357,24783,356,155,1,28654,479091,507745,7917,7,388,-156,3808,506,20742,33,2064,453,8
06-02-20,24581,651,24427,648,154,3,28237,471591,499828,14432,14,381,199,3964,438,20236,29,2031,445,7
06-01-20,23930,605,23779,601,151,4,27414,457982,485396,10441,3,367,-106,3765,708,19798,16,2002,438,6
05-31-20,23325,610,23178,608,147,2,26647,448308,474955,15789,0,364,395,3871,215,19090,44,1986,432,5
05-30-20,22715,461,22570,459,145,2,25938,433228,459166,9751,4,364,165,3476,292,18875,21,1942,427,10
05-29-20,22254,231,22111,228,143,3,25366,424049,449415,7043,4,360,-170,3311,397,18583,14,1921,417,7
05-28-20,22023,599,21883,598,140,1,25101,417271,442372,9289,3,356,221,3481,375,18186,31,1907,410,4
05-27-20,21424,216,21285,210,139,6,24432,408651,433083,6548,10,353,-127,3260,333,17811,26,1876,406,7
05-26-20,21208,356,21075,346,133,10,24238,402297,426535,7024,5,343,-34,3387,385,17478,20,1850,399,4
05-25-20,20852,601,20729,600,123,1,23842,395669,419511,11249,2,338,251,3421,348,17093,27,1830,395,6
05-24-20,20251,331,20129,331,122,0,23130,385132,408262,11936,7,336,120,3170,204,16745,17,1803,389,10
05-23-20,19920,421,19798,416,122,5,22709,373617,396326,11329,14,329,241,3050,166,16541,20,1786,379,6
05-22-20,19499,385,19382,381,117,4,22148,362849,384997,8803,2,315,84,2809,299,16375,28,1766,373,3
05-21-20,19114,385,19001,384,113,1,21722,354472,376194,6904,4,313,-254,2725,635,16076,15,1738,370,8
05-20-20,18729,259,18617,258,112,1,21327,347963,369290,8410,4,309,-314,2979,569,15441,17,1723,362,5
05-19-20,18470,335,18359,334,111,1,21013,339867,360880,6576,4,305,-98,3293,429,14872,25,1706,357,2
05-18-20,18135,343,18025,341,110,2,20623,333681,354304,9109,3,301,0,3391,340,14443,22,1681,355,4
05-17-20,17792,472,17684,472,108,0,20203,324992,345195,13949,3,298,305,3391,164,14103,21,1659,351,7
05-16-20,17320,261,17212,244,108,17,19618,311628,331246,10829,5,295,44,3086,212,13939,17,1638,344,6
05-15-20,17059,193,16968,191,91,2,19254,301163,320417,8302,3,290,-197,3042,387,13727,9,1621,338,8
05-14-20,16866,264,16777,263,89,1,19030,293085,312115,10251,14,287,-117,3239,367,13340,14,1612,330,15
05-13-20,16602,322,16514,319,88,3,18672,283192,301864,10024,9,273,-494,3356,807,12973,27,1598,315,11
05-12-20,16280,697,16195,697,85,0,18295,273545,291840,14848,13,264,-410,3850,1094,12166,22,1571,304,8
05-11-20,15583,555,15498,552,85,3,17482,259510,276992,9925,8,251,179,4260,368,11072,20,1549,296,4
05-10-20,15028,247,14946,244,82,3,16909,250158,267067,10163,1,243,64,4081,182,10704,10,1529,292,4
05-09-20,14781,246,14702,244,79,2,16548,240356,256904,9861,1,242,10,4017,235,10522,13,1519,288,8
05-08-20,14535,195,14458,194,77,1,16222,230821,247043,6609,4,241,-198,4007,389,10287,12,1506,280,6
05-07-20,14340,392,14264,390,76,2,15968,224466,240434,10763,-2,237,79,4205,315,9898,23,1494,274,8
05-06-20,13948,260,13874,260,74,0,15505,214166,229671,5910,13,239,-91,4126,338,9583,13,1471,266,3
05-05-20,13688,189,13614,188,74,1,15185,208576,223761,7844,7,226,-141,4217,323,9245,24,1458,263,10
05-04-20,13499,312,13426,308,73,4,14940,200977,215917,7399,9,219,-306,4358,609,8922,20,1434,253,6
05-03-20,13187,370,13118,364,69,6,14576,193942,208518,9440,1,210,118,4664,251,8313,25,1414,247,9
05-02-20,12817,238,12754,237,63,1,14136,184942,199078,7072,5,209,-99,4546,332,8062,18,1389,238,5
05-01-20,12579,769,12517,764,62,5,13782,178224,192006,9551,5,204,469,4645,295,7730,17,1371,233,5
04-30-20,11810,1002,11753,998,57,4,12968,169487,182455,5059,4,199,779,4176,219,7435,31,1354,228,5
04-29-20,10808,568,10755,566,53,2,11937,165459,177396,11093,7,195,331,3397,230,7216,30,1323,223,5
04-28-20,10240,274,10189,270,51,4,11259,155044,166303,6572,4,188,40,3066,230,6986,32,1293,218,6
04-27-20,9966,297,9919,293,47,4,10952,148779,159731,5429,3,184,-14,3026,308,6756,35,1261,212,5
04-26-20,9669,298,9626,297,43,1,10631,143671,154302,6640,3,181,139,3040,156,6448,17,1226,207,4
04-25-20,9371,302,9329,297,42,5,10282,137380,147662,4518,10,178,132,2901,160,6292,22,1209,203,6
04-24-20,9069,468,9032,459,37,9,9940,133204,143144,16488,-2,168,246,2769,224,6132,40,1187,197,5
04-23-20,8601,452,8573,450,28,2,9241,117415,126656,5147,4,170,300,2523,148,5908,17,1147,192,10
04-22-20,8149,499,8123,497,26,2,8747,112762,121509,8905,9,166,281,2223,209,5760,18,1130,182,3
04-21-20,7650,288,7626,286,24,2,8205,104399,112604,6602,5,157,96,1942,187,5551,24,1112,179,5
04-20-20,7362,251,7340,243,22,8,7880,98122,106002,6532,4,152,27,1846,220,5364,27,1088,174,4
04-19-20,7111,276,7097,276,14,0,7625,91845,99470,5188,3,148,151,1819,122,5144,10,1061,170,3
04-18-20,6835,173,6821,173,14,0,7300,86982,94282,5175,3,145,8,1668,162,5022,11,1051,167,2
04-17-20,6662,320,6648,319,14,1,7027,82080,89107,3240,1,142,125,1660,194,4860,30,1040,165,3
04-16-20,6342,291,6329,291,13,0,6666,79201,85867,4159,6,141,81,1535,204,4666,23,1010,162,6
04-15-20,6051,263,6038,263,13,0,6278,75430,81708,3031,11,135,19,1454,233,4462,18,987,156,6
04-14-20,5788,182,5775,182,13,0,5992,72685,78677,1714,15,124,-48,1435,215,4229,29,969,150,10
04-13-20,5606,217,5593,216,13,1,5773,71190,76963,4604,8,109,-9,1483,218,4014,38,940,140,8
04-12-20,5389,224,5377,222,12,2,5496,66863,72359,4879,0,101,82,1492,142,3796,32,902,132,8
04-11-20,5165,292,5155,292,10,0,5262,62218,67480,5100,3,101,26,1410,263,3654,42,870,124,7
04-10-20,4873,195,4863,194,10,1,4873,57507,62380,2300,4,98,-29,1384,220,3391,22,828,117,2
04-09-20,4678,280,4669,280,9,0,4692,55388,60080,3304,15,94,52,1413,213,3171,42,806,115,5
04-08-20,4398,205,4389,205,9,0,4400,52376,56776,2599,7,79,-46,1361,244,2958,30,764,110,16
04-07-20,4193,305,4184,305,9,0,4187,49990,54177,4602,7,72,59,1407,239,2714,43,734,94,7
04-06-20,3888,228,3879,228,9,0,3861,45714,49575,3621,21,65,-71,1348,278,2475,47,691,87,7
04-05-20,3660,312,3651,311,9,1,3621,42333,45954,3693,1,44,127,1419,184,2197,46,644,80,10
04-04-20,3348,201,3340,201,8,0,3278,38983,42261,3538,6,43,-14,1292,209,2013,26,598,70,4
04-03-20,3147,253,3139,252,8,1,3062,35661,38723,2497,5,37,3,1306,245,1804,42,572,66,16
04-02-20,2894,270,2887,270,7,0,2818,33408,36226,3886,8,32,37,1303,225,1559,58,530,50,6
04-01-20,2624,357,2617,357,7,0,2515,29825,32340,3375,1,24,134,1266,222,1334,58,472,44,8
03-31-20,2267,287,2260,287,7,0,2167,26798,28965,3020,10,23,70,1132,207,1112,46,414,36,8
03-30-20,1980,439,1973,439,7,0,1855,24090,25945,4741,6,13,226,1062,207,905,83,368,28,6
03-29-20,1541,102,1534,102,7,0,1433,19771,21204,653,1,7,-47,836,148,698,35,285,22,6
03-28-20,1439,196,1432,191,7,5,1348,19203,20551,2313,0,6,89,883,107,550,39,250,16,4
03-27-20,1243,207,1241,207,2,0,1157,17081,18238,2577,3,6,96,794,108,443,42,211,12,2
03-26-20,1036,167,1034,166,2,1,968,14693,15661,2854,0,3,84,698,83,335,30,169,10,4
03-25-20,869,157,868,157,1,0,800,12007,12807,2068,1,3,78,614,78,252,35,139,6,1
03-24-20,712,85,711,85,1,0,665,10074,10739,1118,0,2,30,536,55,174,21,104,5,1
03-23-20,627,122,626,122,1,0,595,9026,9621,1574,0,2,84,506,38,119,13,83,4,0
03-22-20,505,133,504,132,1,1,479,7568,8047,1485,1,2,108,422,24,81,27,70,4,1
03-21-20,372,151,372,151,0,0,391,6171,6562,2090,1,1,121,314,29,57,14,43,3,2
03-20-20,221,162,221,162,0,0,244,4228,4472,1080,0,0,142,193,20,28,14,29,1,1
03-19-20,59,30,59,30,0,0,177,3215,3392,834,0,0,22,51,8,8,9,15,0,0
03-18-20,29,11,29,11,0,0,116,2442,2558,591,0,0,11,29,0,0,3,6,0,0
03-17-20,18,4,18,4,0,0,82,1885,1967,1360,0,0,4,18,0,0,0,3,0,0
03-16-20,14,4,14,4,0,0,24,583,607,159,0,0,4,14,0,0,2,3,0,0
03-15-20,10,4,10,4,0,0,21,427,448,28,0,0,4,10,0,0,0,1,0,0
03-14-20,6,5,6,5,0,0,19,401,420,333,0,0,5,6,0,0,1,1,0,0
03-13-20,1,0,1,0,0,0,2,85,87,42,0,0,0,1,0,0,0,0,0,0
03-12-20,1,1,1,1,0,0,2,43,45,45,0,0,1,1,0,0,0,0,0,0
