DATE,TOTAL_CASES,NEW_CASES,TOTAL_CONFIRMED,NEW_CONFIRMED,TOTAL_PROBABLE,NEW_PROBABLE,POS_TESTS,NEG_TESTS,TOTAL_TESTS,NEW_TESTS,NEW_DEATHS,TOTAL_DEATHS,NEW_ACTIVE,TOTAL_ACTIVE,NEW_INACTIVE_RECOVERED,TOTAL_INACTIVE_RECOVERED,NEW_HOSP,TOTAL_HOSP,TOTAL_DEATHS_BY_DOD,NEW_DEATHS_BY_DOD
05-19-21,859701,649,708549,462,151152,187,816614,7058999,7875613,13967,12,12364,-173,6744,810,840593,10,21726,12355,3
05-18-21,859052,577,708087,391,150965,186,816062,7045584,7861646,10664,14,12352,-266,6917,829,839783,15,21716,12352,3
05-17-21,858475,661,707696,390,150779,271,815616,7035366,7850982,9144,12,12338,-307,7183,956,838954,15,21701,12349,9
05-16-21,857814,278,707306,200,150508,78,815147,7026691,7841838,5296,4,12326,-252,7490,526,837998,11,21686,12340,7
05-15-21,857536,399,707106,290,150430,109,814892,7021650,7836542,8617,1,12322,-212,7742,610,837472,10,21675,12333,4
05-14-21,857137,809,706816,578,150321,231,814504,7013421,7827925,12090,10,12321,66,7954,733,836862,24,21665,12329,10
05-13-21,856328,711,706238,469,150090,242,813830,7002005,7815835,12397,7,12311,-176,7888,880,836129,13,21641,12319,5
05-12-21,855617,900,705769,661,149848,239,813274,6990164,7803438,17231,9,12304,-33,8064,924,835249,28,21628,12314,8
05-11-21,854717,847,705108,617,149609,230,812456,6973751,7786207,11475,4,12295,-140,8097,983,834325,26,21600,12306,5
05-10-21,853870,629,704491,374,149379,255,811813,6962919,7774732,7515,16,12291,-571,8237,1184,833342,29,21574,12301,9
05-09-21,853241,376,704117,282,149124,94,811379,6955838,7767217,6855,19,12275,-333,8808,690,832158,18,21545,12292,7
05-08-21,852865,559,703835,394,149030,165,811053,6949309,7760362,10282,0,12256,-81,9141,640,831468,12,21527,12285,8
05-07-21,852306,1036,703441,733,148865,303,810546,6939534,7750080,15003,2,12256,75,9222,959,830828,23,21515,12277,7
05-06-21,851270,789,702708,542,148562,247,809689,6925388,7735077,11577,11,12254,-292,9147,1070,829869,22,21492,12270,9
05-05-21,850481,1209,702166,760,148315,449,809052,6914448,7723500,17621,16,12243,228,9439,965,828799,33,21470,12261,10
05-04-21,849272,854,701406,597,147866,257,808171,6897708,7705879,12173,11,12227,-299,9211,1142,827834,29,21437,12251,9
05-03-21,848418,656,700809,450,147609,206,807471,6886235,7693706,8387,13,12216,-628,9510,1271,826692,28,21408,12242,5
05-02-21,847762,499,700359,373,147403,126,806947,6878372,7685319,7365,1,12203,-220,10138,718,825421,21,21380,12237,10
05-01-21,847263,607,699986,444,147277,163,806506,6871448,7677954,10367,-1,12202,-133,10358,741,824703,22,21359,12227,7
04-30-21,846656,1074,699542,770,147114,304,806003,6861584,7667587,14983,7,12203,12,10491,1055,823962,28,21337,12220,10
04-29-21,845582,1029,698772,681,146810,348,805130,6847474,7652604,14649,9,12196,-117,10479,1137,822907,28,21309,12210,10
04-28-21,844553,1194,698091,858,146462,336,804349,6833606,7637955,20540,17,12187,-95,10596,1272,821770,43,21281,12200,9
04-27-21,843359,1159,697233,710,146126,449,803350,6814065,7617415,13783,8,12170,-82,10691,1233,820498,43,21238,12191,12
04-26-21,842200,1092,696523,713,145677,379,802549,6801083,7603632,9832,11,12162,-375,10773,1456,819265,26,21195,12179,11
04-25-21,841108,552,695810,425,145298,127,801758,6792042,7593800,8248,6,12151,-273,11148,819,817809,25,21169,12168,7
04-24-21,840556,752,695385,564,145171,188,801243,6784309,7585552,13047,0,12145,-176,11421,928,816990,30,21144,12161,7
04-23-21,839804,955,694821,691,144983,264,800595,6771910,7572505,14911,4,12145,-215,11597,1166,816062,22,21114,12154,5
04-22-21,838849,1848,694130,1039,144719,809,799749,6757845,7557594,22085,12,12141,549,11812,1287,814896,31,21092,12149,12
04-21-21,837001,1383,693091,943,143910,440,798557,6736952,7535509,17944,19,12129,119,11263,1245,813609,21,21061,12137,15
04-20-21,835618,1096,692148,900,143470,196,797495,6720070,7517565,13985,14,12110,-257,11144,1339,812364,44,21040,12122,7
04-19-21,834522,842,691248,546,143274,296,796510,6707070,7503580,9282,15,12096,-687,11401,1514,811025,37,20996,12115,11
04-18-21,833680,560,690702,479,142978,81,795896,6698402,7494298,8187,17,12081,-162,12088,705,809511,16,20959,12104,10
04-17-21,833120,705,690223,574,142897,131,795317,6690794,7486111,11807,1,12064,-78,12250,782,808806,17,20943,12094,10
04-16-21,832415,4215,689649,3993,142766,222,794646,6679658,7474304,35546,14,12063,3244,12328,957,808024,37,20926,12084,6
04-15-21,828200,1376,685656,1000,142544,376,789945,6648813,7438758,18283,8,12049,158,9084,1210,807067,33,20889,12078,12
04-14-21,826824,1804,684656,1337,142168,467,788839,6631636,7420475,24938,9,12041,650,8926,1145,805857,36,20856,12066,11
04-13-21,825020,1138,683319,706,141701,432,787312,6608225,7395537,10970,10,12032,-96,8276,1224,804712,33,20820,12055,10
04-12-21,823882,1232,682613,882,141269,350,786554,6598013,7384567,9378,7,12022,-151,8372,1376,803488,30,20787,12045,15
04-11-21,822650,655,681731,461,140919,194,785557,6589632,7375189,7668,3,12015,-186,8523,838,802112,21,20757,12030,5
04-10-21,821995,872,681270,605,140725,267,785036,6582485,7367521,12240,8,12012,122,8709,742,801274,24,20736,12025,10
04-09-21,821123,1338,680665,1043,140458,295,784299,6570982,7355281,16480,3,12004,215,8587,1120,800532,35,20712,12015,13
04-08-21,819785,1149,679622,781,140163,368,783153,6555648,7338801,15056,4,12001,-51,8372,1196,799412,22,20677,12002,5
04-07-21,818636,1585,678841,1188,139795,397,782264,6541481,7323745,21235,21,11997,329,8423,1235,798216,34,20655,11997,8
04-06-21,817051,1336,677653,883,139398,453,780956,6521554,7302510,14562,9,11976,67,8094,1260,796981,26,20621,11989,5
04-05-21,815715,892,676770,516,138945,376,779949,6507999,7287948,6198,38,11967,-619,8027,1473,795721,42,20595,11984,10
04-04-21,814823,552,676254,415,138569,137,779395,6502355,7281750,9622,7,11929,-262,8646,807,794248,10,20553,11974,16
04-03-21,814271,896,675839,637,138432,259,778894,6493234,7272128,10432,0,11922,9,8908,887,793441,17,20543,11958,14
04-02-21,813375,1067,675202,810,138173,257,778168,6483528,7261696,14204,1,11922,-65,8899,1131,792554,17,20526,11944,11
04-01-21,812308,1251,674392,899,137916,352,777214,6470278,7247492,14416,6,11921,-193,8964,1438,791423,18,20509,11933,7
03-31-21,811057,1869,673493,1196,137564,673,776219,6456857,7233076,22840,11,11915,592,9157,1266,789985,29,20491,11926,11
03-30-21,809188,1193,672297,879,136891,314,774833,6435403,7210236,14242,10,11904,-100,8565,1283,788719,34,20462,11915,9
03-29-21,807995,1192,671418,615,136577,577,773810,6422184,7195994,8855,29,11894,-287,8665,1450,787436,25,20428,11906,6
03-28-21,806803,815,670803,566,136000,249,773069,6414070,7187139,10826,13,11865,-45,8952,847,785986,24,20403,11900,8
03-27-21,805988,814,670237,744,135751,70,772420,6403893,7176313,13029,11,11852,3,8997,800,785139,22,20379,11892,9
03-26-21,805174,996,669493,799,135681,197,771514,6391770,7163284,11726,25,11841,-243,8994,1214,784339,14,20357,11883,15
03-25-21,804178,1145,668694,870,135484,275,770662,6380896,7151558,16338,20,11816,-108,9237,1233,783125,35,20343,11868,6
03-24-21,803033,1609,667824,1279,135209,330,769681,6365539,7135220,21274,4,11796,379,9345,1226,781892,28,20308,11862,6
03-23-21,801424,1171,666545,722,134879,449,768318,6345628,7113946,14489,45,11792,-132,8966,1258,780666,33,20280,11856,12
03-22-21,800253,1267,665823,808,134430,459,767505,6331952,7099457,9718,34,11747,-54,9098,1287,779408,35,20247,11844,13
03-21-21,798986,757,665015,562,133971,195,766575,6323164,7089739,8881,8,11713,-9,9152,758,778121,7,20212,11831,13
03-20-21,798229,754,664453,517,133776,237,765954,6314904,7080858,9696,4,11705,-25,9161,775,777363,17,20205,11818,7
03-19-21,797475,1942,663936,1286,133539,656,765397,6305765,7071162,22138,28,11701,757,9186,1157,776588,32,20188,11811,11
03-18-21,795533,1415,662650,966,132883,449,763981,6285043,7049024,18715,23,11673,278,8429,1114,775431,42,20156,11800,14
03-17-21,794118,1071,661684,824,132434,247,762861,6267448,7030309,15441,8,11650,-83,8151,1146,774317,24,20114,11786,19
03-16-21,793047,1937,660860,1246,132187,691,761961,6252907,7014868,19036,12,11642,726,8234,1199,773171,50,20090,11767,9
03-15-21,791110,903,659614,498,131496,405,760517,6235315,6995832,5278,11,11630,-247,7508,1139,771972,24,20040,11758,8
03-14-21,790207,663,659116,461,131091,202,759969,6230585,6990554,8041,0,11619,-91,7755,754,770833,17,20016,11750,15
03-13-21,789544,1486,658655,802,130889,684,759413,6223100,6982513,16650,-12,11619,605,7846,893,770079,22,19999,11735,12
03-12-21,788058,1111,657853,838,130205,273,758477,6207386,6965863,13855,16,11631,-21,7241,1116,769186,13,19977,11723,19
03-11-21,786947,1366,657015,923,129932,443,757474,6194534,6952008,19248,17,11615,169,7262,1180,768070,15,19964,11704,12
03-10-21,785581,1601,656092,1135,129489,466,756445,6176315,6932760,23679,18,11598,302,7093,1281,766890,30,19949,11692,25
03-09-21,783980,1350,654957,806,129023,544,755168,6153913,6909081,17107,32,11580,-37,6791,1355,765609,24,19919,11667,21
03-08-21,782630,1088,654151,677,128479,411,754218,6137756,6891974,7646,9,11548,-555,6828,1634,764254,15,19895,11646,26
03-07-21,781542,753,653474,473,128068,280,753444,6130884,6884328,7138,4,11539,-200,7383,949,762620,9,19880,11620,23
03-06-21,780789,1235,653001,841,127788,394,752868,6124322,6877190,18288,9,11535,171,7583,1055,761671,20,19871,11597,20
03-05-21,779554,1227,652160,780,127394,447,751841,6107061,6858902,14118,33,11526,-68,7412,1262,760616,14,19851,11577,19
03-04-21,778327,1609,651380,1066,126947,543,750925,6093859,6844784,25299,42,11493,570,7480,997,759354,27,19837,11558,18
03-03-21,776718,1309,650314,883,126404,426,749633,6069852,6819485,18081,23,11451,18,6910,1268,758357,22,19810,11540,23
03-02-21,775409,1552,649431,984,125978,568,748600,6052804,6801404,16000,15,11428,529,6892,1008,757089,32,19788,11517,11
03-01-21,773857,568,648447,358,125410,210,747427,6037977,6785404,3825,10,11413,-433,6363,991,756081,16,19756,11506,14
02-28-21,773289,841,648089,582,125200,259,747029,6034550,6781579,10209,18,11403,-68,6796,891,755090,11,19740,11492,13
02-27-21,772448,1438,647507,855,124941,583,746348,6025022,6771370,18087,16,11385,376,6864,1046,754199,23,19729,11479,16
02-26-21,771010,1130,646652,793,124358,337,745309,6007974,6753283,11961,56,11369,-561,6488,1635,753153,16,19706,11463,11
02-25-21,769880,1682,645859,1175,124021,507,744383,5996939,6741322,22429,55,11313,-97,7049,1724,751518,37,19690,11452,23
02-24-21,768198,1923,644684,1476,123514,447,743026,5975867,6718893,24678,68,11258,-40,7146,1895,749794,39,19653,11429,19
02-23-21,766275,1846,643208,1127,123067,719,741295,5952920,6694215,16868,45,11190,-375,7186,2176,747899,44,19614,11410,21
02-22-21,764429,1057,642081,601,122348,456,740053,5937294,6677347,6162,20,11145,-1275,7561,2312,745723,37,19570,11389,23
02-21-21,763372,872,641480,583,121892,289,739351,5931834,6671185,6860,18,11125,-271,8836,1125,743411,15,19533,11366,30
02-20-21,762500,1366,640897,836,121603,530,738649,5925676,6664325,12464,51,11107,-57,9107,1372,742286,31,19518,11336,20
02-19-21,761134,998,640061,643,121073,355,737735,5914126,6651861,6668,7,11056,-925,9164,1916,740914,37,19487,11316,29
02-18-21,760136,1486,639418,952,120718,534,737000,5908193,6645193,12981,72,11049,-645,10089,2059,738998,42,19450,11287,30
02-17-21,758650,932,638466,596,120184,336,735920,5896292,6632212,6597,31,10977,-1297,10734,2198,736939,16,19408,11257,38
02-16-21,757718,1232,637870,784,119848,448,735234,5890381,6625615,9891,17,10946,-1244,12031,2459,734741,30,19392,11219,31
02-15-21,756486,779,637086,453,119400,326,734344,5881380,6615724,6227,4,10929,-2027,13275,2802,732282,13,19362,11188,26
02-14-21,755707,1255,636633,899,119074,356,733817,5875680,6609497,13046,31,10925,-355,15302,1579,729480,23,19349,11162,31
02-13-21,754452,1678,635734,1121,118718,557,732768,5863683,6596451,19167,9,10894,14,15657,1655,727901,30,19326,11131,33
02-12-21,752774,1928,634613,1382,118161,546,731433,5845851,6577284,22324,81,10885,-394,15643,2241,726246,21,19296,11098,27
02-11-21,750846,2421,633231,1739,117615,682,729807,5825153,6554960,25278,81,10804,-274,16037,2614,724005,35,19275,11071,34
02-10-21,748425,2140,631492,1517,116933,623,727814,5801868,6529682,24637,100,10723,-578,16311,2618,721391,39,19240,11037,37
02-09-21,746285,2700,629975,1780,116310,920,726039,5779006,6505045,21681,65,10623,-586,16889,3221,718773,57,19201,11000,40
02-08-21,743585,1249,628195,785,115390,464,723903,5759461,6483364,6683,97,10558,-2327,17475,3479,715552,30,19144,10960,36
02-07-21,742336,1354,627410,940,114926,414,722987,5753694,6476681,12771,6,10461,-435,19802,1783,712073,27,19114,10924,26
02-06-21,740982,3663,626470,2593,114512,1070,721946,5741964,6463910,39411,58,10455,1597,20237,2008,710290,44,19087,10898,58
02-05-21,737319,2184,623877,1569,113442,615,718707,5705792,6424499,22740,203,10397,-768,18640,2749,708282,53,19043,10840,50
02-04-21,735135,2897,622308,2081,112827,816,716746,5685013,6401759,32437,169,10194,-545,19408,3273,705533,69,18990,10790,49
02-03-21,732238,3351,620227,2253,112011,1098,714393,5654929,6369322,27517,133,10025,32,19953,3186,702260,87,18921,10741,40
02-02-21,728887,1315,617974,837,110913,478,711821,5629984,6341805,6562,147,9892,-2878,19921,4046,699074,25,18834,10701,43
02-01-21,727572,1692,617137,1052,110435,640,710916,5624327,6335243,8145,103,9745,-1892,22799,3481,695028,50,18809,10658,51
01-31-21,725880,2176,616085,1382,109795,794,709765,5617333,6327098,17538,76,9642,-2,24691,2102,691547,48,18759,10607,48
01-30-21,723704,3524,614703,2946,109001,578,708037,5601523,6309560,38108,113,9566,805,24693,2606,689445,50,18711,10559,50
01-29-21,720180,1766,611757,1238,108423,528,704510,5566942,6271452,13890,44,9453,-1903,23888,3625,686839,36,18661,10509,55
01-28-21,718414,3963,610519,2019,107895,1944,703012,5554550,6257562,20462,101,9409,-357,25791,4219,683214,82,18625,10454,70
01-27-21,714451,2728,608500,2066,105951,662,700744,5536356,6237100,20356,154,9308,-1243,26148,3817,678995,59,18543,10384,62
01-26-21,711723,3140,606434,2322,105289,818,698455,5518289,6216744,22541,192,9154,-1940,27391,4888,675178,72,18484,10322,82
01-25-21,708583,1822,604112,1221,104471,601,695862,5498341,6194203,11641,111,8962,-3541,29331,5252,670290,52,18412,10240,76
01-24-21,706761,1599,602891,1308,103870,291,694484,5488078,6182562,13244,40,8851,-1657,32872,3216,665038,40,18360,10164,82
01-23-21,705162,4487,601583,3169,103579,1318,692962,5476356,6169318,38167,42,8811,1101,34529,3344,661822,88,18320,10082,73
01-22-21,700675,2635,598414,1965,102261,670,688913,5442238,6131151,21624,93,8769,-2524,33428,5066,658478,52,18232,10009,74
01-21-21,698040,4711,596449,3507,101591,1204,686632,5422895,6109527,31114,128,8676,-1948,35952,6531,653412,82,18180,9935,107
01-20-21,693329,3114,592942,2095,100387,1019,682682,5395731,6078413,19976,86,8548,-2772,37900,5800,646881,57,18098,9828,86
01-19-21,690215,4774,590847,2772,99368,2002,680235,5378202,6058437,22859,40,8462,-3159,40672,7893,641081,111,18041,9742,99
01-18-21,685441,1616,588075,1067,97366,549,676910,5358668,6035578,7862,39,8422,-7211,43831,8788,633188,41,17930,9643,80
01-17-21,683825,2569,587008,1875,96817,694,675820,5351896,6027716,15257,36,8383,-1884,51042,4417,624400,52,17889,9563,90
01-16-21,681256,6930,585133,5343,96123,1587,673752,5338707,6012459,46121,44,8347,1312,52926,5574,619983,122,17837,9473,89
01-15-21,674326,2760,579790,1813,94536,947,667232,5299106,5966338,14583,79,8303,-665,51614,3346,614409,57,17715,9384,90
01-14-21,671566,6158,577977,4797,93589,1361,665254,5286501,5951755,37431,84,8224,-279,52279,6353,611063,98,17658,9294,106
01-13-21,665408,4120,573180,2877,92228,1243,659696,5254628,5914324,20740,137,8140,-4021,52558,8004,604710,65,17560,9188,77
01-12-21,661288,4748,570303,3008,90985,1740,656686,5236898,5893584,20606,146,8003,-5993,56579,10595,596706,75,17495,9111,98
01-11-21,656540,3787,567295,2679,89245,1108,653432,5219546,5872978,14873,80,7857,-6335,62572,10042,586111,77,17420,9013,102
01-10-21,652753,5382,564616,3698,88137,1684,650499,5207606,5858105,29949,81,7777,1032,68907,4269,576069,84,17343,8911,107
01-09-21,647371,7220,560918,5751,86453,1469,645884,5182272,5828156,39411,86,7696,2003,67875,5131,571800,88,17259,8804,89
01-08-21,640151,6049,555167,4572,84984,1477,639179,5149566,5788745,33874,126,7610,4236,65872,1687,566669,96,17171,8715,118
01-07-21,634102,7341,550595,6301,83507,1040,633204,5121667,5754871,33692,111,7484,3153,61636,4077,564982,98,17075,8597,91
01-06-21,626761,7361,544294,5161,82467,2200,626837,5094342,5721179,28876,114,7373,440,58483,6807,560905,129,16977,8506,115
01-05-21,619400,8407,539133,5140,80267,3267,621305,5070998,5692303,25831,99,7259,-776,58043,9084,554098,129,16848,8391,115
01-04-21,610993,4050,533993,3001,77000,1049,615978,5050494,5666472,10897,143,7160,-4622,58819,8529,545014,67,16719,8276,107
01-03-21,606943,3515,530992,2375,75951,1140,613000,5042575,5655575,12412,55,7017,-260,63441,3720,536485,56,16652,8169,103
01-02-21,603428,7200,528617,5731,74811,1469,610551,5032612,5643163,30051,15,6962,3111,63701,4074,532765,99,16596,8066,86
01-01-21,596228,6680,522886,5226,73342,1454,603975,5009137,5613112,28068,48,6947,-402,60590,7034,528691,76,16497,7980,98
12-31-20,589548,9175,517660,7235,71888,1940,598368,4986676,5585044,35514,97,6899,1925,60992,7153,521657,74,16421,7882,99
12-30-20,580373,6702,510425,4531,69948,2171,590283,4959247,5549530,22251,100,6802,-713,59067,7315,514504,81,16347,7783,99
12-29-20,573671,8082,505894,4953,67777,3129,585340,4941939,5527279,23337,122,6702,63,59780,7897,507189,115,16266,7684,98
12-28-20,565589,3549,500941,2632,64648,917,580015,4923927,5503942,10183,76,6580,-6606,59717,10079,499292,78,16151,7586,89
12-27-20,562040,3379,498309,2294,63731,1085,577163,4916596,5493759,13197,69,6504,-453,66323,3763,489213,76,16073,7497,87
12-26-20,558661,4889,496015,3546,62646,1343,574377,4906185,5480562,21744,7,6435,829,66776,4053,485450,85,15997,7410,92
12-25-20,553772,6630,492469,5438,61303,1192,570495,4888323,5458818,33416,5,6428,-603,65947,7228,481397,54,15912,7318,80
12-24-20,547142,6646,487031,5030,60111,1616,564464,4860938,5425402,32448,51,6423,-568,66550,7163,474169,46,15858,7238,106
12-23-20,540496,6097,482001,3970,58495,2127,558737,4834217,5392954,26396,111,6372,-1370,67118,7356,467006,84,15812,7132,97
12-22-20,534399,6911,478031,4714,56368,2197,554160,4812398,5366558,29089,133,6261,-860,68488,7638,459650,125,15728,7035,109
12-21-20,527488,5823,473317,4379,54171,1444,548878,4788591,5337469,26618,65,6128,-3973,69348,9731,452012,83,15603,6926,104
12-20-20,521665,9998,468938,8345,52727,1653,543984,4766867,5310851,61066,54,6063,6415,73321,3529,442281,106,15520,6822,101
12-19-20,511667,7078,460593,6035,51074,1043,534417,4715368,5249785,41320,57,6009,3171,66906,3850,438752,70,15414,6721,93
12-18-20,504589,8268,454558,6981,50031,1287,527015,4681450,5208465,40590,115,5952,1837,63735,6316,434902,93,15344,6628,96
12-17-20,496321,10189,447577,8090,48744,2099,519572,4648303,5167875,44541,177,5837,3144,61898,6868,428586,115,15251,6532,92
12-16-20,486132,9378,439487,6522,46645,2856,510905,4612429,5123334,35802,53,5660,2295,58754,7030,421718,145,15136,6440,85
12-15-20,476754,11904,432965,10385,43789,1519,503787,4583745,5087532,65211,74,5607,4652,56459,7178,414688,158,14991,6355,66
12-14-20,464850,7985,422580,6910,42270,1075,492082,4530239,5022321,42299,79,5533,-2531,51807,10437,407510,112,14833,6289,76
12-13-20,456865,11295,415670,9908,41195,1387,484313,4495709,4980022,68968,62,5454,7813,54338,3420,397073,125,14721,6213,85
12-12-20,445570,8984,405762,7345,39808,1639,473240,4437814,4911054,47610,73,5392,5081,46525,3830,393653,136,14596,6128,80
12-11-20,436586,6081,398417,5144,38169,937,464944,4398500,4863444,32160,87,5319,1740,41444,4254,389823,116,14460,6048,68
12-10-20,430505,8934,393273,7806,37232,1128,459327,4371957,4831284,52301,69,5232,7597,39704,1268,385569,122,14344,5980,75
12-09-20,421571,5825,385467,5138,36104,687,450528,4328455,4778983,27607,62,5163,154,32107,5609,384301,100,14222,5905,62
12-08-20,415746,8105,380329,7025,35417,1080,444893,4306483,4751376,45064,100,5101,2333,31953,5672,378692,105,14122,5843,79
12-07-20,407641,7162,373304,6155,34337,1007,437183,4269129,4706312,35777,66,5001,-730,29620,7826,373020,87,14017,5764,72
12-06-20,400479,4061,367149,3420,33330,641,430509,4240026,4670535,19691,38,4935,1162,30350,2861,365194,46,13930,5692,86
12-05-20,396418,3073,363729,2522,32689,551,426765,4224079,4650844,15628,29,4897,9,29188,3035,362333,51,13884,5606,78
12-04-20,393345,5393,361207,4316,32138,1077,424085,4211131,4635216,27000,95,4868,-326,29179,5624,359298,94,13833,5528,83
12-03-20,387952,4821,356891,4010,31061,811,419235,4188981,4608216,25638,93,4773,580,29505,4148,353674,81,13739,5445,72
12-02-20,383131,2515,352881,2121,30250,394,414760,4167818,4582578,11857,50,4680,-2564,28925,5029,349526,61,13658,5373,67
12-01-20,380616,6707,350760,5708,29856,999,412602,4158119,4570721,36181,36,4630,1056,31489,5615,344497,110,13597,5306,68
11-30-20,373909,6008,345052,5433,28857,575,406454,4128086,4534540,40760,48,4594,-1180,30433,7140,338882,89,13487,5238,80
11-29-20,367901,5543,339619,5113,28282,430,400458,4093322,4493780,37941,13,4546,2510,31613,3020,331742,72,13398,5158,58
11-28-20,362358,4732,334506,4104,27852,628,394731,4061108,4455839,31936,15,4533,1637,29103,3080,328722,75,13326,5100,62
11-27-20,357626,5439,330402,4847,27224,592,390136,4033767,4423903,32649,7,4518,418,27466,5014,325642,81,13251,5038,80
11-26-20,352187,5301,325555,4939,26632,362,384574,4006680,4391254,52394,53,4511,-440,27048,5688,320628,60,13170,4958,47
11-25-20,346886,2183,320616,1582,26270,601,378687,3960173,4338860,12062,92,4458,-2389,27488,4480,314940,91,13110,4911,64
11-24-20,344703,2059,319034,1521,25669,538,377240,3949558,4326798,10738,73,4366,-3445,29877,5431,310460,91,13019,4847,66
11-23-20,342644,2214,317513,1853,25131,361,375732,3940328,4316060,11119,35,4293,-4682,33322,6861,305029,70,12928,4781,69
11-22-20,340430,5567,315660,5064,24770,503,373860,3931081,4304941,43864,55,4258,2913,38004,2599,298168,111,12858,4712,59
11-21-20,334863,3423,310596,2904,24267,519,368161,3892916,4261077,25934,9,4203,796,35091,2618,295569,81,12747,4653,74
11-20-20,331440,4053,307692,3537,23748,516,364999,3870144,4235143,24343,74,4194,-38,34295,4017,292951,66,12666,4579,67
11-19-20,327387,3004,304155,2287,23232,717,361165,3849635,4210800,16864,80,4120,-1358,34333,4282,288934,81,12600,4512,57
11-18-20,324383,4045,301868,3056,22515,989,358730,3835206,4193936,24019,53,4040,-93,35691,4085,284652,96,12519,4455,43
11-17-20,320338,3507,298812,3183,21526,324,355276,3814641,4169917,21243,72,3987,-128,35784,3563,280567,66,12423,4412,68
11-16-20,316831,4656,295629,4245,21202,411,351712,3796962,4148674,35165,30,3915,-76,35912,4702,277004,78,12357,4344,51
11-15-20,312175,6473,291384,5859,20791,614,347056,3766453,4113509,55524,16,3885,4526,35988,1931,272302,111,12279,4293,48
11-14-20,305702,4900,285525,4462,20177,438,340437,3717548,4057985,38286,25,3869,3071,31462,1804,270371,85,12168,4245,60
11-13-20,300802,4375,281063,3755,19739,620,335410,3684289,4019699,27170,64,3844,1537,28391,2774,268567,70,12083,4185,43
11-12-20,296427,3147,277308,2576,19119,571,331407,3661122,3992529,19297,27,3780,410,26854,2710,265793,55,12013,4142,36
11-11-20,293280,3928,274732,3304,18548,624,328664,3644568,3973232,28176,89,3753,990,26444,2849,263083,72,11958,4106,50
11-10-20,289352,3033,271428,2493,17924,540,324827,3620229,3945056,25725,62,3664,93,25454,2878,260234,83,11886,4056,50
11-09-20,286319,2384,268935,2053,17384,331,322061,3597270,3919331,19717,15,3602,-882,25361,3251,257356,43,11803,4006,42
11-08-20,283935,5408,266882,4866,17053,542,319759,3579855,3899614,55008,5,3587,3588,26243,1815,254105,89,11760,3964,40
11-07-20,278527,4188,262016,3856,16511,332,314222,3530384,3844606,43216,49,3582,2265,22655,1874,252290,87,11671,3924,33
11-06-20,274339,3602,258160,3027,16179,575,309709,3491681,3801390,28584,32,3533,953,20390,2617,250416,62,11584,3891,47
11-05-20,270737,1405,255133,1110,15604,295,306339,3466467,3772806,10920,31,3501,-1315,19437,2689,247799,52,11522,3844,40
11-04-20,269332,2648,254023,2347,15309,301,305122,3456764,3761886,23447,24,3470,-167,20752,2791,245110,68,11470,3804,50
11-03-20,266684,3019,251676,2715,15008,304,302511,3435928,3738439,24953,75,3446,234,20919,2710,242319,54,11402,3754,45
11-02-20,263665,1903,248961,1779,14704,124,299454,3414032,3713486,16693,26,3371,-1340,20685,3217,239609,64,11348,3709,38
11-01-20,261762,2483,247182,2118,14580,365,297503,3399290,3696793,34033,0,3345,776,22025,1707,236392,64,11284,3671,32
10-31-20,259279,149,245064,137,14215,12,295004,3367756,3662760,807,12,3345,-1543,21249,1680,234685,2,11220,3639,29
10-30-20,259130,2405,244927,2186,14203,219,294865,3367088,3661953,22327,78,3333,90,22792,2237,233005,62,11218,3610,40
10-29-20,256725,2374,242741,2040,13984,334,292530,3347096,3639626,25465,22,3255,29,22702,2323,230768,66,11156,3570,38
10-28-20,254351,2678,240701,2391,13650,287,290234,3323927,3614161,23113,34,3233,138,22673,2506,228445,67,11090,3532,38
10-27-20,251673,2446,238310,2039,13363,407,287599,3303449,3591048,22843,44,3199,-15,22535,2417,225939,101,11023,3494,46
10-26-20,249227,1507,236271,1319,12956,188,285309,3282896,3568205,11258,32,3155,-1380,22550,2855,223522,45,10922,3448,31
10-25-20,247720,3084,234952,2896,12768,188,283861,3273086,3556947,35750,31,3123,1585,23930,1468,220667,82,10877,3417,42
10-24-20,244636,3609,232056,3313,12580,296,280384,3240813,3521197,39877,24,3092,1918,22345,1667,219199,85,10795,3375,45
10-23-20,241027,2655,228743,2404,12284,251,276565,3204755,3481320,29993,65,3068,503,20427,2087,217532,73,10710,3330,33
10-22-20,238372,3183,226339,2831,12033,352,273895,3177432,3451327,35909,41,3003,1133,19924,2009,215445,90,10637,3297,28
10-21-20,235189,1734,223508,1487,11681,247,270690,3144728,3415418,15344,18,2962,-531,18791,2247,213436,44,10547,3269,38
10-20-20,233455,1967,222021,1682,11434,285,268976,3131098,3400074,18700,30,2944,-77,19322,2014,211189,60,10503,3231,37
10-19-20,231488,2190,220339,1996,11149,194,266951,3114423,3381374,20251,13,2914,-176,19399,2353,209175,91,10443,3194,33
10-18-20,229298,2637,218343,2462,10955,175,264911,3096212,3361123,39722,6,2901,1326,19575,1305,206822,73,10352,3161,21
10-17-20,226661,2684,215881,2478,10780,206,262000,3059401,3321401,36781,32,2895,1306,18249,1346,205517,75,10279,3140,27
10-16-20,223977,1719,213403,1526,10574,193,259012,3025608,3284620,16346,7,2863,-138,16943,1850,204171,44,10204,3113,29
10-15-20,222258,1425,211877,1220,10381,205,257441,3010833,3268274,16242,36,2856,-326,17081,1715,202321,52,10160,3084,41
10-14-20,220833,2312,210657,2109,10176,203,256098,2995934,3252032,22128,31,2820,565,17407,1716,200606,68,10108,3043,37
10-13-20,218521,1544,208548,1268,9973,276,253889,2976015,3229904,16119,23,2789,-16,16842,1537,198890,54,10040,3006,36
10-12-20,216977,1232,207280,1049,9697,183,252447,2961338,3213785,15371,7,2766,-825,16858,2050,197353,43,9986,2970,36
10-11-20,215745,2950,206231,2748,9514,202,251243,2947171,3198414,42921,9,2759,1854,17683,1087,195303,92,9943,2934,28
10-10-20,212795,1886,203483,1778,9312,108,248089,2907404,3155493,29451,26,2750,836,15829,1024,194216,51,9851,2906,29
10-09-20,210909,1418,201705,1246,9204,172,246063,2879979,3126042,26240,27,2724,54,14993,1337,193192,41,9800,2877,26
10-08-20,209491,2003,200459,1813,9032,190,244654,2855148,3099802,25617,63,2697,537,14939,1403,191855,67,9759,2851,26
10-07-20,207488,1842,198646,1575,8842,267,242717,2831468,3074185,23391,21,2634,351,14402,1470,190452,74,9692,2825,28
10-06-20,205646,1999,197071,1700,8575,299,240974,2809820,3050794,25400,24,2613,447,14051,1528,188982,91,9618,2797,27
10-05-20,203647,2217,195371,2003,8276,214,239009,2786385,3025394,35566,20,2589,369,13604,1828,187454,90,9527,2770,25
10-04-20,201430,1820,193368,1666,8062,154,236513,2753315,2989828,38328,17,2569,885,13235,918,185626,67,9437,2745,29
10-03-20,199610,1356,191702,1244,7908,112,234324,2717176,2951500,29131,45,2552,341,12350,970,184708,44,9370,2716,18
10-02-20,198254,1206,190458,1065,7796,141,232729,2689640,2922369,15627,14,2507,-297,12009,1489,183738,43,9326,2698,22
10-01-20,197048,1149,189393,1008,7655,141,231443,2675299,2906742,18503,47,2493,-308,12306,1410,182249,51,9283,2676,21
09-30-20,195899,1429,188385,1253,7514,176,230254,2657985,2888239,13517,34,2446,-86,12614,1481,180839,36,9232,2655,26
09-29-20,194470,1191,187132,975,7338,216,228788,2645934,2874722,20750,31,2412,-293,12700,1453,179358,63,9196,2629,14
09-28-20,193279,678,186157,547,7122,131,227488,2626484,2853972,8424,12,2381,-1227,12993,1893,177905,32,9133,2615,26
09-27-20,192601,1367,185610,1277,6991,90,226776,2618772,2845548,29532,3,2369,436,14220,928,176012,54,9101,2589,24
09-26-20,191234,2122,184333,1980,6901,142,225229,2590787,2816016,44230,22,2366,1032,13784,1068,175084,60,9047,2565,23
09-25-20,189112,1345,182353,1246,6759,99,222746,2549040,2771786,26156,42,2344,-118,12752,1421,174016,48,8987,2542,23
09-24-20,187767,1400,181107,1231,6660,169,221228,2524402,2745630,27202,35,2302,-104,12870,1469,172595,51,8939,2519,20
09-23-20,186367,917,179876,799,6491,118,219716,2498712,2718428,9436,14,2267,-627,12974,1530,171126,25,8888,2499,28
09-22-20,185450,1645,179077,1422,6373,223,218782,2490210,2708992,25551,28,2253,-182,13601,1799,169596,56,8863,2471,20
09-21-20,183805,668,177655,522,6150,146,216883,2466558,2683441,7093,15,2225,-394,13783,1047,167797,40,8807,2451,20
09-20-20,183137,1029,177133,915,6004,114,216174,2460174,2676348,20447,2,2210,139,14177,888,166750,38,8767,2431,26
09-19-20,182108,2138,176218,2037,5890,101,214970,2440931,2655901,48406,20,2208,1214,14038,904,165862,82,8729,2405,18
09-18-20,179970,1504,174181,1333,5789,171,212458,2395037,2607495,30080,32,2188,-312,12824,1784,164958,49,8647,2387,28
09-17-20,178466,1827,172848,1686,5618,141,210763,2366652,2577415,27799,13,2156,427,13136,1387,163174,54,8598,2359,26
09-16-20,176639,1063,171162,926,5477,137,208719,2340897,2549616,16767,24,2143,-377,12709,1416,161787,41,8544,2333,21
09-15-20,175576,1911,170236,1686,5340,225,207526,2325323,2532849,34224,30,2119,308,13086,1573,160371,68,8503,2312,17
09-14-20,173665,1600,168550,1435,5115,165,205243,2293382,2498625,22960,19,2089,-74,12778,1655,158798,78,8435,2295,27
09-13-20,172065,1400,167115,1315,4950,85,203456,2272209,2475665,22930,14,2070,389,12852,997,157143,44,8357,2268,14
09-12-20,170665,1334,165800,1257,4865,77,201763,2250972,2452735,26748,39,2056,466,12463,829,156146,42,8313,2254,35
09-11-20,169331,1008,164543,895,4788,113,200109,2225878,2425987,14959,37,2017,-1370,11997,2341,155317,40,8271,2219,28
09-10-20,168323,2002,163648,1823,4675,179,198993,2212035,2411028,31628,57,1980,513,13367,1432,152976,76,8231,2191,23
09-09-20,166321,1153,161825,1046,4496,107,196756,2182644,2379400,17738,35,1923,-338,12854,1456,151544,56,8155,2168,23
09-08-20,165168,818,160779,708,4389,110,195410,2166252,2361662,13091,27,1888,-754,13192,1545,150088,47,8099,2145,25
09-07-20,164350,783,160071,736,4279,47,194553,2154018,2348571,8058,4,1861,-963,13946,1742,148543,33,8052,2120,17
09-06-20,163567,828,159335,775,4232,53,193416,2147097,2340513,12313,3,1857,-62,14909,887,146801,38,8019,2103,35
09-05-20,162739,2561,158560,2491,4179,70,192503,2135697,2328200,35069,25,1854,1527,14971,1009,145914,48,7981,2068,21
09-04-20,160178,1118,156069,1038,4109,80,189577,2103554,2293131,13467,22,1829,-158,13444,1254,144905,46,7933,2047,21
09-03-20,159060,1658,155031,1515,4029,143,188389,2091275,2279664,28417,18,1807,22,13602,1618,143651,56,7887,2026,22
09-02-20,157402,1190,153516,1082,3886,108,186492,2064755,2251247,16475,16,1789,-328,13580,1502,142033,53,7831,2004,23
09-01-20,156212,1700,152434,1536,3778,164,185251,2049521,2234772,22896,27,1773,117,13908,1556,140531,66,7778,1981,22
08-31-20,154512,1247,150898,1177,3614,70,183268,2028608,2211876,12933,7,1746,-350,13791,1590,138975,39,7712,1959,24
08-30-20,153265,1462,149721,1428,3544,34,181852,2017091,2198943,8728,22,1739,525,14141,915,137385,34,7673,1935,16
08-29-20,151803,1534,148293,1425,3510,109,180247,2009968,2190215,25360,24,1717,365,13616,1145,136470,51,7639,1919,25
08-28-20,150269,1128,146868,1074,3401,54,178459,1986396,2164855,12674,28,1693,-482,13251,1582,135325,43,7588,1894,23
08-27-20,149141,2334,145794,2211,3347,123,177186,1974995,2152181,37152,25,1665,903,13733,1406,133743,67,7545,1871,25
08-26-20,146807,1325,143583,1209,3224,116,174466,1940563,2115029,18262,20,1640,-397,12830,1702,132337,56,7478,1846,30
08-25-20,145482,1713,142374,1595,3108,118,172924,1923843,2096767,30311,40,1620,115,13227,1558,130635,68,7422,1816,24
08-24-20,143769,645,140779,532,2990,113,170922,1895534,2066456,7173,21,1580,-1405,13112,2029,129077,41,7354,1792,35
08-23-20,143124,815,140247,751,2877,64,170214,1889069,2059283,14428,4,1559,-206,14517,1017,127048,42,7313,1757,24
08-22-20,142309,2437,139496,2374,2813,63,169298,1875557,2044855,52017,14,1555,1242,14723,1181,126031,71,7271,1733,17
08-21-20,139872,528,137122,485,2750,43,166367,1826471,1992838,10322,61,1541,-1227,13481,1694,124850,31,7200,1716,20
08-20-20,139344,2446,136637,2272,2707,174,165805,1816711,1982516,42966,36,1480,752,14708,1658,123156,84,7169,1696,20
08-19-20,136898,1346,134365,1280,2533,66,162998,1776552,1939550,20200,26,1444,-541,13956,1861,121498,55,7085,1676,22
08-18-20,135552,1784,133085,1664,2467,120,161438,1757912,1919350,37973,39,1418,-206,14497,1951,119637,63,7030,1654,16
08-17-20,133768,854,131421,717,2347,137,158957,1722420,1881377,9314,21,1379,-1301,14703,2134,117686,57,6967,1638,19
08-16-20,132914,1410,130704,1383,2210,27,158080,1713983,1872063,20010,21,1358,304,16004,1085,115552,42,6910,1619,30
08-15-20,131504,1944,129321,1858,2183,86,156278,1695775,1852053,27240,19,1337,600,15700,1325,114467,60,6868,1589,29
08-14-20,129560,1385,127463,1303,2097,82,153760,1671053,1824813,15146,13,1318,-342,15100,1714,113142,47,6808,1560,22
08-13-20,128175,2529,126160,2430,2015,99,152119,1657548,1809667,36807,24,1305,585,15442,1920,111428,123,6761,1538,24
08-12-20,125646,1256,123730,1215,1916,41,148766,1624094,1772860,13615,18,1281,-763,14857,2001,109508,59,6638,1514,24
08-11-20,124390,1812,122515,1698,1875,114,147386,1611859,1759245,24276,38,1263,-169,15620,1943,107507,77,6579,1490,26
08-10-20,122578,904,120817,852,1761,52,145209,1589760,1734969,8470,10,1225,-1483,15789,2377,105564,71,6502,1464,29
08-09-20,121674,1575,119965,1547,1709,28,144230,1582269,1726499,17497,8,1215,460,17272,1107,103187,50,6431,1435,14
08-08-20,120099,2112,118418,2049,1681,63,142326,1566676,1709002,33931,9,1207,944,16812,1159,102080,56,6381,1421,21
08-07-20,117987,1797,116369,1745,1618,52,139692,1535379,1675071,18555,20,1198,103,15868,1674,100921,102,6325,1400,25
08-06-20,116190,2743,114624,2630,1566,113,137533,1518983,1656516,32155,42,1178,989,15765,1712,99247,106,6223,1375,25
08-05-20,113447,1345,111994,1277,1453,68,134246,1490115,1624361,14153,27,1136,-665,14776,1983,97535,55,6117,1350,17
08-04-20,112102,1759,110717,1675,1385,84,132715,1477493,1610208,21038,25,1109,-387,15441,2121,95552,96,6062,1333,20
08-03-20,110343,1806,109042,1772,1301,34,130612,1458558,1589170,16895,19,1084,-707,15828,2494,93431,63,5966,1313,25
08-02-20,108537,1080,107270,1056,1267,24,128528,1443747,1572275,13175,6,1065,-73,16535,1147,90937,53,5903,1288,37
08-01-20,107457,2179,106214,2150,1243,29,127243,1431857,1559100,31965,7,1059,825,16608,1347,89790,67,5850,1251,23
07-31-20,105278,1754,104064,1705,1214,49,124450,1402685,1527135,18356,27,1052,-115,15783,1842,88443,68,5783,1228,27
07-30-20,103524,3592,102359,3549,1165,43,122496,1386283,1508779,43237,13,1025,1651,15898,1928,86601,138,5715,1201,29
07-29-20,99932,1185,98810,1156,1122,29,118115,1347427,1465542,9366,21,1012,-1252,14247,2416,84673,70,5577,1172,32
07-28-20,98747,2515,97654,2471,1093,44,116850,1339326,1456176,28752,21,991,131,15499,2363,82257,137,5507,1140,21
07-27-20,96232,1925,95183,1887,1049,38,113756,1313668,1427424,18054,11,970,-803,15368,2717,79894,107,5370,1119,17
07-26-20,94307,2329,93296,2276,1011,53,111492,1297878,1409370,26810,3,959,993,16171,1333,77177,80,5263,1102,21
07-25-20,91978,3102,91020,3062,958,40,108645,1273915,1382560,42421,26,956,1613,15178,1463,75844,117,5183,1081,20
07-24-20,88876,1864,87958,1818,918,46,104436,1235703,1340139,19350,13,930,-351,13565,2202,74381,99,5066,1061,28
07-23-20,87012,2547,86140,2498,872,49,102443,1218346,1320789,37691,37,917,398,13916,2112,72179,126,4967,1033,27
07-22-20,84465,2002,83642,1973,823,29,99220,1183878,1283098,17104,17,880,-465,13518,2450,70067,94,4841,1006,30
07-21-20,82463,3168,81669,3141,794,27,96920,1169074,1265994,39906,24,863,606,13983,2538,67617,155,4747,976,17
07-20-20,79295,1204,78528,1167,767,37,93000,1133088,1226088,9668,4,839,-1607,13377,2807,65079,54,4592,959,20
07-19-20,78091,1583,77361,1560,730,23,91682,1124738,1216420,18789,5,835,-18,14984,1596,62272,63,4538,939,16
07-18-20,76508,2133,75801,2111,707,22,89733,1107898,1197631,26482,23,830,826,15002,1284,60676,82,4475,923,17
07-17-20,74375,2133,73690,2088,685,45,87037,1084112,1171149,22074,19,807,517,14176,1597,59392,90,4393,906,16
07-16-20,72242,2977,71602,2934,640,43,84476,1064599,1149075,39896,13,788,1109,13659,1855,57795,115,4303,890,19
07-15-20,69265,1934,68668,1897,597,37,80597,1028582,1109179,19687,16,775,-124,12550,2042,55940,95,4188,871,17
07-14-20,67331,2123,66771,2081,560,42,78397,1011095,1089492,23625,18,759,214,12674,1891,53898,100,4093,854,11
07-13-20,65208,1831,64690,1800,518,31,75903,989964,1065867,17329,8,741,-101,12460,1924,52007,75,3993,843,19
07-12-20,63377,2324,62890,2299,487,25,73901,974637,1048538,28259,3,733,1220,12561,1101,50083,101,3918,824,17
07-11-20,61053,1179,60591,1165,462,14,71035,949244,1020279,15439,15,730,11,11341,1153,48982,51,3817,807,13
07-10-20,59874,1981,59426,1953,448,28,69482,935358,1004840,18338,13,715,566,11330,1402,47829,93,3766,794,17
07-09-20,57893,1807,57473,1780,420,27,67260,919242,986502,25175,25,702,374,10764,1408,46427,89,3673,777,17
07-08-20,56086,1654,55693,1629,393,25,65190,896137,961327,19200,20,677,60,10390,1574,45019,81,3584,760,12
07-07-20,54432,2154,54064,2144,368,10,63303,878824,942127,27248,12,657,719,10330,1423,43445,112,3503,748,18
07-06-20,52278,892,51920,878,358,14,60631,854248,914879,8255,7,645,-617,9611,1502,42022,60,3391,730,11
07-05-20,51386,1346,51042,1344,344,2,59710,846914,906624,15261,9,638,573,10228,764,40520,42,3331,719,18
07-04-20,50040,1461,49698,1459,342,2,58130,833233,891363,21507,4,629,625,9655,832,39756,57,3289,701,17
07-03-20,48579,1350,48239,1342,340,8,56265,813591,869856,16408,13,625,313,9030,1024,38924,55,3232,684,12
07-02-20,47229,1923,46897,1915,332,8,54771,798677,853448,26109,11,612,987,8717,925,37900,82,3177,672,9
07-01-20,45306,1429,44982,1424,324,5,52450,774889,827339,18374,5,601,465,7730,959,36975,61,3095,663,13
06-30-20,43877,1654,43558,1642,319,12,50742,758223,808965,25387,12,596,773,7265,869,36016,64,3034,650,12
06-29-20,42223,1787,41916,1780,307,7,48555,735023,783578,23018,0,584,794,6492,993,35147,89,2970,638,8
06-28-20,40436,655,40136,653,300,2,46537,714023,760560,10259,0,584,221,5698,434,34154,16,2881,630,8
06-27-20,39781,264,39483,258,298,6,45716,704585,750301,1850,7,584,-334,5477,591,33720,20,2865,622,8
06-26-20,39517,979,39225,955,292,24,45477,702974,748451,10323,10,577,290,5811,679,33129,59,2845,614,14
06-25-20,38538,1083,38270,1073,268,10,44458,693670,738128,14114,11,567,444,5521,628,32450,48,2786,600,9
06-24-20,37455,842,37197,834,258,8,43225,680789,724014,8465,14,556,121,5077,707,31822,48,2738,591,7
06-23-20,36613,1017,36363,1010,250,7,42243,673306,715549,11214,11,542,364,4956,642,31115,59,2690,584,5
06-22-20,35596,626,35353,614,243,12,41102,663233,704335,10540,5,531,-187,4592,808,30473,25,2631,579,6
06-21-20,34970,596,34739,595,231,1,40485,653310,693795,13747,2,526,203,4779,391,29665,21,2606,573,10
06-20-20,34374,409,34144,408,230,1,39640,640408,680048,9216,0,524,-61,4576,470,29274,24,2585,563,6
06-19-20,33965,745,33736,740,229,5,39091,631741,670832,10189,15,524,217,4637,513,28804,40,2561,557,9
06-18-20,33220,1098,32996,1096,224,2,38196,622447,660643,15629,12,509,499,4420,587,28291,70,2521,548,5
06-17-20,32122,409,31900,405,222,4,36943,608071,645014,5422,4,497,-221,3921,626,27704,22,2451,543,10
06-16-20,31713,614,31495,611,218,3,36524,603068,639592,7445,10,493,140,4142,464,27078,37,2429,533,6
06-15-20,31099,712,30884,699,215,13,35874,596273,632147,10494,8,483,19,4002,685,26614,37,2392,527,15
06-14-20,30387,607,30185,602,202,5,35067,586586,621653,13783,3,475,258,3983,346,25929,26,2355,512,9
06-13-20,29780,541,29583,536,197,5,34328,573542,607870,10693,4,472,159,3725,378,25583,21,2329,503,7
06-12-20,29239,546,29047,543,192,3,33596,563581,597177,9630,27,468,-43,3566,562,25205,31,2308,496,4
06-11-20,28693,615,28504,612,189,3,32974,554573,587547,9566,5,441,-159,3609,769,24643,26,2277,492,5
06-10-20,28078,427,27892,422,186,5,32275,545706,577981,8283,1,436,-181,3768,607,23874,40,2251,487,1
06-09-20,27651,585,27470,580,181,5,31903,537795,569698,9621,14,435,-48,3949,619,23267,38,2211,486,4
06-08-20,27066,489,26890,485,176,4,31229,528848,560077,9954,3,421,98,3997,388,22648,27,2173,482,5
06-07-20,26577,428,26405,426,172,2,30673,519450,550123,13953,1,418,157,3899,270,22260,22,2146,477,5
06-06-20,26149,471,25979,468,170,3,30049,506121,536170,10915,9,417,190,3742,272,21990,21,2124,472,10
06-05-20,25678,511,25511,502,167,9,29486,495769,525255,11831,7,408,8,3552,496,21718,20,2103,462,6
06-04-20,25167,227,25009,224,158,3,28874,484550,513424,5698,13,401,-265,3544,479,21222,19,2083,456,3
06-03-20,24940,357,24785,356,155,1,28659,479067,507726,7923,7,388,-156,3809,506,20743,33,2064,453,8
06-02-20,24583,651,24429,648,154,3,28242,471561,499803,14418,14,381,199,3965,438,20237,29,2031,445,7
06-01-20,23932,605,23781,601,151,4,27419,457966,485385,10440,3,367,-106,3766,708,19799,16,2002,438,6
05-31-20,23327,610,23180,608,147,2,26652,448293,474945,15607,0,364,395,3872,215,19091,44,1986,432,5
05-30-20,22717,461,22572,459,145,2,25946,433392,459338,9727,4,364,165,3477,292,18876,21,1942,427,10
05-29-20,22256,231,22113,228,143,3,25377,424234,449611,7119,4,360,-170,3312,397,18584,14,1921,417,7
05-28-20,22025,599,21885,598,140,1,25112,417380,442492,9275,3,356,221,3482,375,18187,31,1907,410,4
05-27-20,21426,216,21287,210,139,6,24440,408777,433217,6554,10,353,-126,3261,332,17812,26,1876,406,7
05-26-20,21210,356,21077,346,133,10,24248,402415,426663,7020,5,343,-34,3387,385,17480,20,1850,399,4
05-25-20,20854,601,20731,600,123,1,23847,395796,419643,11221,2,338,251,3421,348,17095,27,1830,395,6
05-24-20,20253,331,20131,331,122,0,23136,385286,408422,11949,7,336,120,3170,204,16747,17,1803,389,10
05-23-20,19922,421,19800,416,122,5,22719,373754,396473,11358,14,329,241,3050,166,16543,20,1786,379,6
05-22-20,19501,385,19384,381,117,4,22156,362959,385115,8791,2,315,84,2809,299,16377,28,1766,373,3
05-21-20,19116,385,19003,384,113,1,21732,354592,376324,6764,4,313,-254,2725,635,16078,15,1738,370,8
05-20-20,18731,259,18619,258,112,1,21342,348218,369560,8512,4,309,-314,2979,569,15443,17,1723,362,5
05-19-20,18472,335,18361,334,111,1,21026,340022,361048,6569,4,305,-98,3293,429,14874,25,1706,357,2
05-18-20,18137,343,18027,341,110,2,20636,333843,354479,8927,3,301,0,3391,340,14445,22,1681,355,4
05-17-20,17794,472,17686,472,108,0,20218,325334,345552,14076,3,298,305,3391,164,14105,21,1659,351,7
05-16-20,17322,261,17214,244,108,17,19623,311853,331476,11074,5,295,44,3086,212,13941,17,1638,344,6
05-15-20,17061,193,16970,191,91,2,19241,301161,320402,8262,3,290,-197,3042,387,13729,9,1621,338,8
05-14-20,16868,264,16779,263,89,1,19022,293118,312140,10212,14,287,-117,3239,367,13342,14,1612,330,15
05-13-20,16604,322,16516,319,88,3,18671,283257,301928,10051,9,273,-494,3356,807,12975,27,1598,315,11
05-12-20,16282,697,16197,697,85,0,18289,273588,291877,14885,13,264,-410,3850,1094,12168,22,1571,304,8
05-11-20,15585,555,15500,552,85,3,17473,259519,276992,9912,8,251,179,4260,368,11074,20,1549,296,4
05-10-20,15030,247,14948,244,82,3,16899,250181,267080,10156,1,243,64,4081,182,10706,10,1529,292,4
05-09-20,14783,246,14704,244,79,2,16539,240385,256924,9843,1,242,10,4017,235,10524,13,1519,288,8
05-08-20,14537,195,14460,194,77,1,16213,230868,247081,6611,4,241,-198,4007,389,10289,12,1506,280,6
05-07-20,14342,392,14266,390,76,2,15965,224505,240470,10766,-2,237,79,4205,315,9900,23,1494,274,8
05-06-20,13950,260,13876,260,74,0,15501,214203,229704,5908,13,239,-92,4126,339,9585,13,1471,266,3
05-05-20,13690,189,13616,188,74,1,15182,208614,223796,7847,7,226,-141,4218,323,9246,24,1458,263,10
05-04-20,13501,312,13428,308,73,4,14937,201012,215949,7108,9,219,-306,4359,609,8923,20,1434,253,6
05-03-20,13189,371,13120,365,69,6,14576,194265,208841,9464,1,210,119,4665,251,8314,25,1414,247,9
05-02-20,12818,238,12755,237,63,1,14138,185239,199377,7041,5,209,-99,4546,332,8063,18,1389,238,5
05-01-20,12580,769,12518,764,62,5,13785,178551,192336,9535,5,204,469,4645,295,7731,17,1371,233,5
04-30-20,11811,1002,11754,998,57,4,12974,169827,182801,5068,4,199,779,4176,219,7436,31,1354,228,5
04-29-20,10809,568,10756,566,53,2,11943,165790,177733,11038,7,195,331,3397,230,7217,30,1323,223,5
04-28-20,10241,274,10190,270,51,4,11275,155420,166695,6584,4,188,40,3066,230,6987,32,1293,218,6
04-27-20,9967,297,9920,293,47,4,10966,149145,160111,5450,3,184,-14,3026,308,6757,35,1261,212,5
04-26-20,9670,298,9627,297,43,1,10646,144015,154661,6615,3,181,139,3040,156,6449,17,1226,207,4
04-25-20,9372,302,9330,297,42,5,10299,137747,148046,4502,10,178,132,2901,160,6293,22,1209,203,6
04-24-20,9070,469,9033,460,37,9,9959,133585,143544,14347,-2,168,247,2769,224,6133,40,1187,197,5
04-23-20,8601,452,8573,450,28,2,9396,119801,129197,5111,4,170,300,2522,148,5909,17,1147,192,10
04-22-20,8149,499,8123,497,26,2,8912,115174,124086,8908,9,166,281,2222,209,5761,18,1130,182,3
04-21-20,7650,288,7626,286,24,2,8375,106803,115178,6858,5,157,96,1941,187,5552,24,1112,179,5
04-20-20,7362,251,7340,243,22,8,8043,100277,108320,6513,4,152,27,1845,220,5365,27,1088,174,4
04-19-20,7111,276,7097,276,14,0,7785,94022,101807,5191,3,148,151,1818,122,5145,10,1061,170,3
04-18-20,6835,173,6821,173,14,0,7461,89155,96616,5092,3,145,8,1667,162,5023,11,1051,167,2
04-17-20,6662,320,6648,319,14,1,7215,84309,91524,3263,1,142,125,1659,194,4861,30,1040,165,3
04-16-20,6342,291,6329,291,13,0,6851,81410,88261,4141,6,141,81,1534,204,4667,23,1010,162,6
04-15-20,6051,263,6038,263,13,0,6484,77636,84120,3116,11,135,19,1453,233,4463,18,987,156,6
04-14-20,5788,182,5775,182,13,0,6173,74831,81004,1772,15,124,-48,1434,215,4230,29,969,150,10
04-13-20,5606,217,5593,216,13,1,5939,73293,79232,4725,8,109,-9,1482,218,4015,38,940,140,8
04-12-20,5389,224,5377,222,12,2,5636,68871,74507,4951,0,101,82,1491,142,3797,32,902,132,8
04-11-20,5165,292,5155,292,10,0,5393,64163,69556,5311,3,101,26,1409,263,3655,42,870,124,7
04-10-20,4873,195,4863,194,10,1,4972,59273,64245,2384,4,98,-29,1383,220,3392,22,828,117,2
04-09-20,4678,280,4669,280,9,0,4789,57072,61861,3276,15,94,52,1412,213,3172,42,806,115,5
04-08-20,4398,205,4389,205,9,0,4505,54080,58585,2888,7,79,-46,1360,244,2959,30,764,110,16
04-07-20,4193,305,4184,305,9,0,4264,51433,55697,4940,7,72,59,1406,239,2715,43,734,94,7
04-06-20,3888,228,3879,228,9,0,3923,46834,50757,3632,21,65,-71,1347,278,2476,47,691,87,7
04-05-20,3660,312,3651,311,9,1,3684,43441,47125,3629,1,44,127,1418,184,2198,46,644,80,10
04-04-20,3348,201,3340,201,8,0,3349,40147,43496,3576,6,43,-14,1291,209,2014,26,598,70,4
04-03-20,3147,253,3139,252,8,1,3132,36788,39920,2489,5,37,2,1305,246,1805,42,572,66,16
04-02-20,2894,270,2887,270,7,0,2895,34536,37431,3981,8,32,37,1303,225,1559,58,530,50,6
04-01-20,2624,357,2617,357,7,0,2591,30859,33450,3629,1,24,134,1266,222,1334,58,472,44,8
03-31-20,2267,287,2260,287,7,0,2231,27590,29821,3026,10,23,70,1132,207,1112,46,414,36,8
03-30-20,1980,439,1973,439,7,0,1920,24875,26795,4937,6,13,226,1062,207,905,83,368,28,6
03-29-20,1541,102,1534,102,7,0,1483,20375,21858,823,1,7,-47,836,148,698,35,285,22,6
03-28-20,1439,196,1432,191,7,5,1390,19645,21035,2373,0,6,89,883,107,550,39,250,16,4
03-27-20,1243,207,1241,207,2,0,1195,17467,18662,2847,3,6,96,794,108,443,42,211,12,2
03-26-20,1036,167,1034,166,2,1,987,14828,15815,2939,0,3,84,698,83,335,30,169,10,4
03-25-20,869,157,868,157,1,0,811,12065,12876,2111,1,3,78,614,78,252,35,139,6,1
03-24-20,712,85,711,85,1,0,669,10096,10765,1125,0,2,30,536,55,174,21,104,5,1
03-23-20,627,122,626,122,1,0,598,9042,9640,1576,0,2,84,506,38,119,13,83,4,0
03-22-20,505,133,504,132,1,1,480,7584,8064,1486,1,2,108,422,24,81,27,70,4,1
03-21-20,372,151,372,151,0,0,391,6187,6578,2090,1,1,121,314,29,57,14,43,3,2
03-20-20,221,162,221,162,0,0,244,4244,4488,1080,0,0,142,193,20,28,14,29,1,1
03-19-20,59,30,59,30,0,0,177,3231,3408,832,0,0,22,51,8,8,9,15,0,0
03-18-20,29,11,29,11,0,0,117,2459,2576,591,0,0,11,29,0,0,3,6,0,0
03-17-20,18,4,18,4,0,0,83,1902,1985,1360,0,0,4,18,0,0,0,3,0,0
03-16-20,14,4,14,4,0,0,25,600,625,159,0,0,4,14,0,0,2,3,0,0
03-15-20,10,4,10,4,0,0,22,444,466,28,0,0,4,10,0,0,0,1,0,0
03-14-20,6,5,6,5,0,0,20,418,438,333,0,0,5,6,0,0,1,1,0,0
03-13-20,1,0,1,0,0,0,3,102,105,42,0,0,0,1,0,0,0,0,0,0
03-12-20,1,1,1,1,0,0,3,60,63,45,0,0,1,1,0,0,0,0,0,0
03-11-20,0,0,0,0,0,0,1,17,18,0,0,0,0,0,0,0,0,0,0,0
03-10-20,0,0,0,0,0,0,1,17,18,0,0,0,0,0,0,0,0,0,0,0
03-09-20,0,0,0,0,0,0,1,17,18,0,0,0,0,0,0,0,0,0,0,0
03-07-20,0,0,0,0,0,0,1,17,18,0,0,0,0,0,0,0,0,0,0,0
03-06-20,0,0,0,0,0,0,1,17,18,0,0,0,0,0,0,0,0,0,0,0
03-05-20,0,0,0,0,0,0,1,17,18,0,0,0,0,0,0,0,0,0,0,0
01-01-60,0,0,0,0,0,0,1,17,18,18,0,0,0,0,0,0,0,0,0,0
