date_stamp,iso3166_1,cnt_confirmed,cnt_deaths,cnt_recovered,cnt_active
2022-05-02,AD,41349,153,0,41196
2022-05-02,AE,899033,2302,0,896731
2022-05-02,AF,178901,7683,0,171218
2022-05-02,AG,7626,136,0,7490
2022-05-02,AL,275177,3496,0,271681
2022-05-02,AM,422874,8622,0,414252
2022-05-02,AO,99287,1900,0,97387
2022-05-02,AR,9083673,128653,0,8955020
2022-05-02,AT,4149004,18170,0,4130834
2022-05-02,AU,6030240,7310,0,6022930
2022-05-02,AZ,792579,9709,0,782870
2022-05-02,BA,377087,15765,0,361322
2022-05-02,BB,70793,398,0,70395
2022-05-02,BD,1952726,29127,0,1923599
2022-05-02,BE,4071279,31494,0,4039785
2022-05-02,BF,20865,383,0,20482
2022-05-02,BG,1157199,36920,0,1120279
2022-05-02,BH,569370,1476,0,567894
2022-05-02,BI,40397,38,0,40359
2022-05-02,BJ,26952,163,0,26789
2022-05-02,BN,141911,218,0,141693
2022-05-02,BO,905074,21923,0,883151
2022-05-02,BR,30460997,663838,0,29797159
2022-05-02,BS,33582,798,0,32784
2022-05-02,BT,59247,21,0,59226
2022-05-02,BW,305984,2688,0,303296
2022-05-02,BY,980345,6947,0,973398
2022-05-02,BZ,57497,676,0,56821
2022-05-02,CA,3770995,39338,0,3731657
2022-05-02,CD,87023,1337,0,85686
2022-05-02,CF,14649,113,0,14536
2022-05-02,CG,24079,385,0,23694
2022-05-02,CH,3619598,13714,0,3605884
2022-05-02,CI,81957,799,0,81158
2022-05-02,CL,3562521,57541,0,3504980
2022-05-02,CM,119780,1927,0,117853
2022-05-02,CN,2227785,14430,0,2213355
2022-05-02,CO,6092667,139797,0,5952870
2022-05-02,CR,852074,8405,0,843669
2022-05-02,CU,1103286,8527,0,1094759
2022-05-02,CV,56028,401,0,55627
2022-05-02,CY,480220,1020,0,479200
2022-05-02,CZ,3907793,40175,0,3867618
2022-05-02,DE,24927339,135701,0,24791638
2022-05-02,DJ,15631,189,0,15442
2022-05-02,DK,3164735,6232,0,3158503
2022-05-02,DM,12161,63,0,12098
2022-05-02,DO,579443,4376,0,575067
2022-05-02,DZ,265782,6875,0,258907
2022-05-02,EC,869696,35598,0,834098
2022-05-02,EE,572193,2539,0,569654
2022-05-02,EG,515645,24613,0,491032
2022-05-02,ER,9734,103,0,9631
2022-05-02,ES,11896152,104456,0,11791696
2022-05-02,ET,470587,7510,0,463077
2022-05-02,FI,1023013,3939,0,1019074
2022-05-02,FJ,64646,862,0,63784
2022-05-02,FM,7,0,0,7
2022-05-02,FR,28881384,147179,0,28734205
2022-05-02,GA,47602,304,0,47298
2022-05-02,GB,22214111,175552,0,22038559
2022-05-02,GD,14743,220,0,14523
2022-05-02,GE,1655221,16811,0,1638410
2022-05-02,GH,161204,1445,0,159759
2022-05-02,GM,11995,365,0,11630
2022-05-02,GN,36549,442,0,36107
2022-05-02,GQ,15907,183,0,15724
2022-05-02,GR,3331288,29205,0,3302083
2022-05-02,GT,846632,17613,0,829019
2022-05-02,GW,8202,171,0,8031
2022-05-02,GY,63484,1228,0,62256
2022-05-02,HN,426179,10893,0,415286
2022-05-02,HR,1123029,15843,0,1107186
2022-05-02,HT,30697,835,0,29862
2022-05-02,HU,1903200,46266,0,1856934
2022-05-02,ID,6047208,156287,0,5890921
2022-05-02,IE,1517112,7087,0,1510025
2022-05-02,IL,4080480,10697,0,4069783
2022-05-02,IN,43084913,523889,0,42561024
2022-05-02,IQ,2325247,25211,0,2300036
2022-05-02,IR,7223005,141114,0,7081891
2022-05-02,IS,185579,119,0,185460
2022-05-02,IT,16523859,163736,0,16360123
2022-05-02,JM,130299,2967,0,127332
2022-05-02,JO,1695745,14064,0,1681681
2022-05-02,JP,7917391,29631,0,7887760
2022-05-02,KE,323792,5649,0,318143
2022-05-02,KG,200993,2991,0,198002
2022-05-02,KH,136254,3056,0,133198
2022-05-02,KI,3084,13,0,3071
2022-05-02,KM,8106,160,0,7946
2022-05-02,KN,5566,43,0,5523
2022-05-02,KR,17346753,23007,0,17323746
2022-05-02,KW,631409,2555,0,628854
2022-05-02,KZ,1394530,19013,0,1375517
2022-05-02,LA,207714,744,0,206970
2022-05-02,LB,1097044,10387,0,1086657
2022-05-02,LC,23459,368,0,23091
2022-05-02,LI,17199,84,0,17115
2022-05-02,LK,663408,16505,0,646903
2022-05-02,LR,7434,294,0,7140
2022-05-02,LS,33134,697,0,32437
2022-05-02,LT,1058537,9105,0,1049432
2022-05-02,LU,238917,1068,0,237849
2022-05-02,LV,822726,5770,0,816956
2022-05-02,LY,501916,6430,0,495486
2022-05-02,MA,1164984,16069,0,1148915
2022-05-02,MC,11801,57,0,11744
2022-05-02,MD,516986,11489,0,505497
2022-05-02,ME,235338,2715,0,232623
2022-05-02,MG,64181,1391,0,62790
2022-05-02,MH,17,0,0,17
2022-05-02,MK,309769,9280,0,300489
2022-05-02,ML,30850,732,0,30118
2022-05-02,MM,612914,19434,0,593480
2022-05-02,MN,920781,2179,0,918602
2022-05-02,MR,58694,982,0,57712
2022-05-02,MT,91975,700,0,91275
2022-05-02,MU,221749,992,0,220757
2022-05-02,MV,179171,298,0,178873
2022-05-02,MW,85790,2634,0,83156
2022-05-02,MX,5740080,324350,0,5415730
2022-05-02,MY,4450859,35555,0,4415304
2022-05-02,MZ,225387,2201,0,223186
2022-05-02,NA,158811,4025,0,154786
2022-05-02,NE,8943,309,0,8634
2022-05-02,NG,255753,3143,0,252610
2022-05-02,NI,18491,234,0,18257
2022-05-02,NL,8232276,22883,0,8209393
2022-05-02,NO,1426491,2932,0,1423559
2022-05-02,NP,978836,11951,0,966885
2022-05-02,NZ,957813,732,0,957081
2022-05-02,OM,389126,4258,0,384868
2022-05-02,PA,777658,8185,0,769473
2022-05-02,PE,3566523,212865,0,3353658
2022-05-02,PG,43821,650,0,43171
2022-05-02,PH,3686082,60410,0,3625672
2022-05-02,PK,1527956,30369,0,1497587
2022-05-02,PL,5996935,116059,0,5880876
2022-05-02,PS,657060,5657,0,651403
2022-05-02,PT,3853800,22280,0,3831520
2022-05-02,PW,4610,6,0,4604
2022-05-02,PY,649455,18870,0,630585
2022-05-02,QA,364728,677,0,364051
2022-05-02,RO,2894896,65496,0,2829400
2022-05-02,RS,2007091,16002,0,1991089
2022-05-02,RU,17930267,368595,0,17561672
2022-05-02,RW,129834,1459,0,128375
2022-05-02,SA,754238,9093,0,745145
2022-05-02,SB,15677,141,0,15536
2022-05-02,SC,42548,166,0,42382
2022-05-02,SD,62117,4931,0,57186
2022-05-02,SE,2500917,18772,0,2482145
2022-05-02,SG,1200976,1338,0,1199638
2022-05-02,SI,1010785,6595,0,1004190
2022-05-02,SK,2528216,19879,0,2508337
2022-05-02,SL,7681,125,0,7556
2022-05-02,SM,16476,115,0,16361
2022-05-02,SN,86005,1966,0,84039
2022-05-02,SO,26485,1361,0,25124
2022-05-02,SR,79336,1328,0,78008
2022-05-02,SS,17483,138,0,17345
2022-05-02,ST,5964,73,0,5891
2022-05-02,SV,162089,4128,0,157961
2022-05-02,SY,55825,3150,0,52675
2022-05-02,SZ,70678,1397,0,69281
2022-05-02,TD,7412,193,0,7219
2022-05-02,TG,36991,273,0,36718
2022-05-02,TH,4281536,28778,0,4252758
2022-05-02,TJ,17786,125,0,17661
2022-05-02,TL,22874,130,0,22744
2022-05-02,TN,1040193,28550,0,1011643
2022-05-02,TO,10452,11,0,10441
2022-05-02,TR,15034917,98791,0,14936126
2022-05-02,TT,148630,3833,0,144797
2022-05-02,TW,132955,868,0,132087
2022-05-02,TZ,33872,803,0,33069
2022-05-02,UA,5040518,112459,0,4928059
2022-05-02,UG,164104,3597,0,160507
2022-05-02,US,81444332,993999,0,80450333
2022-05-02,UY,897867,7203,0,890664
2022-05-02,UZ,238627,1637,0,236990
2022-05-02,VA,29,0,0,29
2022-05-02,VC,8419,106,0,8313
2022-05-02,VE,522434,5709,0,516725
2022-05-02,VN,10656649,43044,0,10613605
2022-05-02,VU,7514,13,0,7501
2022-05-02,WS,9592,19,0,9573
2022-05-02,XK,228094,3138,0,224956
2022-05-02,YE,11819,2149,0,9670
2022-05-02,ZA,3798413,100370,0,3698043
2022-05-02,ZM,319755,3976,0,315779
2022-05-02,ZW,247935,5470,0,242465
