date_stamp,iso3166_1,cnt_confirmed,cnt_deaths,cnt_recovered,cnt_active
2023-02-25,AD,47866,165,0,47701
2023-02-25,AE,1051732,2349,0,1049383
2023-02-25,AF,209246,7896,0,201350
2023-02-25,AG,9106,146,0,8960
2023-02-25,AL,334373,3598,0,330775
2023-02-25,AM,446819,8721,0,438098
2023-02-25,AO,105205,1931,0,103274
2023-02-25,AR,10043308,130458,0,9912850
2023-02-25,AT,5897047,21872,0,5875175
2023-02-25,AU,11366361,19373,0,11346988
2023-02-25,AZ,828492,10116,0,818376
2023-02-25,BA,401575,16278,0,385297
2023-02-25,BB,106645,575,0,106070
2023-02-25,BD,2037773,29445,0,2008328
2023-02-25,BE,4717655,33717,0,4683938
2023-02-25,BF,22056,396,0,21660
2023-02-25,BG,1296642,38211,0,1258431
2023-02-25,BH,706250,1548,0,704702
2023-02-25,BI,53609,38,0,53571
2023-02-25,BJ,27990,163,0,27827
2023-02-25,BN,277992,225,0,277767
2023-02-25,BO,1192696,22364,0,1170332
2023-02-25,BR,37020531,698928,0,36321603
2023-02-25,BS,37491,833,0,36658
2023-02-25,BT,62615,21,0,62594
2023-02-25,BW,329662,2801,0,326861
2023-02-25,BY,994037,7118,0,986919
2023-02-25,BZ,70740,688,0,70052
2023-02-25,CA,4600513,51375,0,4549138
2023-02-25,CD,95646,1464,0,94182
2023-02-25,CF,15368,113,0,15255
2023-02-25,CG,25077,388,0,24689
2023-02-25,CH,4411059,14203,0,4396856
2023-02-25,CI,88182,834,0,87348
2023-02-25,CL,5161209,64158,0,5097051
2023-02-25,CM,124328,1965,0,122363
2023-02-25,CN,4903524,101040,0,4802484
2023-02-25,CO,6357173,142315,0,6214858
2023-02-25,CR,1199055,9214,0,1189841
2023-02-25,CU,1112578,8530,0,1104048
2023-02-25,CV,63240,413,0,62827
2023-02-25,CY,649093,1305,0,647788
2023-02-25,CZ,4607883,42422,0,4565461
2023-02-25,DE,38111063,167812,0,37943251
2023-02-25,DJ,15690,189,0,15501
2023-02-25,DK,3449604,8293,0,3441311
2023-02-25,DM,15760,74,0,15686
2023-02-25,DO,660533,4384,0,656149
2023-02-25,DZ,271439,6881,0,264558
2023-02-25,EC,1056578,36008,0,1020570
2023-02-25,EE,614852,2934,0,611918
2023-02-25,EG,515698,24809,0,490889
2023-02-25,ER,10189,103,0,10086
2023-02-25,ES,13763336,119380,0,13643956
2023-02-25,ET,499959,7572,0,492387
2023-02-25,FI,1462169,8892,0,1453277
2023-02-25,FJ,68889,883,0,68006
2023-02-25,FM,23671,60,0,23611
2023-02-25,FR,39813898,165918,0,39647980
2023-02-25,GA,48981,306,0,48675
2023-02-25,GB,24603373,219721,0,24383652
2023-02-25,GD,19680,238,0,19442
2023-02-25,GE,1825598,16965,0,1808633
2023-02-25,GH,171172,1462,0,169710
2023-02-25,GM,12586,372,0,12214
2023-02-25,GN,38267,467,0,37800
2023-02-25,GQ,17229,183,0,17046
2023-02-25,GR,5548487,34779,0,5513708
2023-02-25,GT,1235918,20167,0,1215751
2023-02-25,GW,8953,176,0,8777
2023-02-25,GY,73066,1298,0,71768
2023-02-25,HN,471557,11109,0,460448
2023-02-25,HR,1268666,17950,0,1250716
2023-02-25,HT,34143,860,0,33283
2023-02-25,HU,2194969,48745,0,2146224
2023-02-25,ID,6735451,160905,0,6574546
2023-02-25,IE,1703244,8655,0,1694589
2023-02-25,IL,4797557,12268,0,4785289
2023-02-25,IN,44687243,530769,0,44156474
2023-02-25,IQ,2465545,25375,0,2440170
2023-02-25,IR,7567619,144835,0,7422784
2023-02-25,IS,208999,211,0,208788
2023-02-25,IT,25576852,188094,0,25388758
2023-02-25,JM,154065,3500,0,150565
2023-02-25,JO,1746997,14122,0,1732875
2023-02-25,JP,33194709,72214,0,33122495
2023-02-25,KE,342900,5688,0,337212
2023-02-25,KG,206633,2991,0,203642
2023-02-25,KH,138714,3056,0,135658
2023-02-25,KI,5013,18,0,4995
2023-02-25,KM,8998,161,0,8837
2023-02-25,KN,6596,46,0,6550
2023-02-25,KP,1,6,0,-5
2023-02-25,KR,30489666,33940,0,30455726
2023-02-25,KW,663456,2570,0,660886
2023-02-25,KZ,1497449,19068,0,1478381
2023-02-25,LA,218015,758,0,217257
2023-02-25,LB,1231577,10823,0,1220754
2023-02-25,LC,29882,409,0,29473
2023-02-25,LI,21395,89,0,21306
2023-02-25,LK,672026,16830,0,655196
2023-02-25,LR,8065,294,0,7771
2023-02-25,LS,34790,723,0,34067
2023-02-25,LT,1304023,9582,0,1294441
2023-02-25,LU,315945,1215,0,314730
2023-02-25,LV,975928,6258,0,969670
2023-02-25,LY,507171,6437,0,500734
2023-02-25,MA,1272442,16296,0,1256146
2023-02-25,MC,16108,67,0,16041
2023-02-25,MD,603750,11974,0,591776
2023-02-25,ME,288088,2801,0,285287
2023-02-25,MG,67852,1421,0,66431
2023-02-25,MH,15598,17,0,15581
2023-02-25,MK,346852,9662,0,337190
2023-02-25,ML,32997,743,0,32254
2023-02-25,MM,633907,19490,0,614417
2023-02-25,MN,1007896,2136,0,1005760
2023-02-25,MR,63667,997,0,62670
2023-02-25,MT,117338,827,0,116511
2023-02-25,MU,295440,1044,0,294396
2023-02-25,MV,185729,311,0,185418
2023-02-25,MW,88681,2686,0,85995
2023-02-25,MX,7443151,332938,0,7110213
2023-02-25,MY,5042188,36957,0,5005231
2023-02-25,MZ,233098,2242,0,230856
2023-02-25,NA,171121,4090,0,167031
2023-02-25,NE,9508,315,0,9193
2023-02-25,NG,266463,3155,0,263308
2023-02-25,NI,15627,245,0,15382
2023-02-25,NL,8706836,23707,0,8683129
2023-02-25,NO,1478888,5175,0,1473713
2023-02-25,NP,1001140,12020,0,989120
2023-02-25,NR,5247,1,0,5246
2023-02-25,NZ,2215578,2536,0,2213042
2023-02-25,OM,399449,4628,0,394821
2023-02-25,PA,1031014,8603,0,1022411
2023-02-25,PE,4485282,219395,0,4265887
2023-02-25,PG,46792,670,0,46122
2023-02-25,PH,4076064,66083,0,4009981
2023-02-25,PK,1576795,30641,0,1546154
2023-02-25,PL,6414853,118868,0,6295985
2023-02-25,PS,703228,5708,0,697520
2023-02-25,PT,5566708,26117,0,5540591
2023-02-25,PW,5988,9,0,5979
2023-02-25,PY,808327,19870,0,788457
2023-02-25,QA,493724,686,0,493038
2023-02-25,RO,3335131,67675,0,3267456
2023-02-25,RS,2490311,17807,0,2472504
2023-02-25,RU,21932062,388033,0,21544029
2023-02-25,RW,133170,1468,0,131702
2023-02-25,SA,829228,9613,0,819615
2023-02-25,SB,24575,153,0,24422
2023-02-25,SC,50665,172,0,50493
2023-02-25,SD,63787,5011,0,58776
2023-02-25,SE,2697827,23662,0,2674165
2023-02-25,SG,2222006,1722,0,2220284
2023-02-25,SI,1327413,7071,0,1320342
2023-02-25,SK,2664862,21016,0,2643846
2023-02-25,SL,7760,126,0,7634
2023-02-25,SM,23536,122,0,23414
2023-02-25,SN,88917,1971,0,86946
2023-02-25,SO,27324,1361,0,25963
2023-02-25,SR,82227,1400,0,80827
2023-02-25,SS,18368,138,0,18230
2023-02-25,ST,6281,77,0,6204
2023-02-25,SV,201785,4230,0,197555
2023-02-25,SY,57463,3164,0,54299
2023-02-25,SZ,74199,1423,0,72776
2023-02-25,TD,7675,194,0,7481
2023-02-25,TG,39371,290,0,39081
2023-02-25,TH,4727831,33902,0,4693929
2023-02-25,TJ,17786,125,0,17661
2023-02-25,TL,23418,138,0,23280
2023-02-25,TN,1150793,29330,0,1121463
2023-02-25,TO,16801,13,0,16788
2023-02-25,TR,17042722,101492,0,16941230
2023-02-25,TT,188737,4339,0,184398
2023-02-25,TV,2805,0,0,2805
2023-02-25,TW,9970937,17672,0,9953265
2023-02-25,TZ,42823,846,0,41977
2023-02-25,UA,5693596,119146,0,5574450
2023-02-25,UG,170478,3630,0,166848
2023-02-25,US,103372978,1119560,0,102253418
2023-02-25,UY,1034046,7617,0,1026429
2023-02-25,UZ,250932,1637,0,249295
2023-02-25,VA,29,0,0,29
2023-02-25,VC,9589,123,0,9466
2023-02-25,VE,551957,5852,0,546105
2023-02-25,VN,11526891,43186,0,11483705
2023-02-25,VU,12014,14,0,12000
2023-02-25,WS,16607,29,0,16578
2023-02-25,XK,273002,3207,0,269795
2023-02-25,YE,11945,2159,0,9786
2023-02-25,ZA,4061383,102595,0,3958788
2023-02-25,ZM,342831,4055,0,338776
2023-02-25,ZW,263921,5663,0,258258
